Ph.D.	PHD
Hon.	honorable
Mt.	Mount
Maj.	Major
Rev.	Reverend
w/o	without
a/c number	account number
c/o	care of
Gov.	governor
vs.	versus
vs	versus
dept.	department
prof.	professor
est.	estimated
vol	volume
vol.	volume
bldg.	building
Bldg.	Building
apt.	apartment
Apt.	Apartment
World War I	World War one
World War II	World War two
etc.	etcetera.
SnO2	tin four oxide
dept	department
HVAC	H-vac
SPDR	spider
ZIP	zip
~	approximately
κ	kappa
ω	omega
α	alpha
ν	nu
δ	delta
Δ	delta
Α	alpha
β	beta
Β	beta
χ	chi
Χ	chi
ε	epsilon
Ε	epsilon
φ	phi
Φ	phi
γ	gamma
Γ	gamma
η	eta
Η	eta
ι	iota
Ι	iota
κ	kappa
Κ	kappa
λ	lambda
Λ	lambda
μ	mu
Μ	mu
ν	nu
Ν	nu
ο	omicron
Ο	omicron
π	pi
Π	pi
θ	theta
Θ	theta
ρ	rho
Ρ	rho
σ	sigma
Σ	sigma
τ	tau
Τ	tau
υ	upsilon
Υ	upsilon
ω	omega
Ω	omega
ξ	xi
Ξ	xi
ψ	psi
Ψ	psi
ζ	zeta
Ζ	zeta
ltd	limited
int'l	international
A. D	AD
A.D	AD
a. d	AD
a.d	AD
a. d.	AD
a.d.	AD
B. C	BC
B.C	BC
b. c	BC
b.c	BC
A. D.	AD
A.D.	AD
B. C.	BC
B.C.	BC
b. c.	BC
b.c.	BC
A. A.	a a
A.A.	AA
A&A	A and A
AAAs	AAA's
AaB	AAB
Aabo	AABO
aac	AAC
AACNo	AACNO
AADTs	AADT's
Aadu	AADU
AAFld	AAFLD
Aap	AAP
A. B.	AB
A.B.	AB
Abhi	ABHI
abl	ABL
Abl	ABL
Abp	ABP
Abr	ABR
abv	ABV
Abz	ABZ
A&C	A and C
A. C.	AC
A.C.	AC
A/C	AC
acac	ACAC
Acad	ACAD
ACC&S	ACC and S
Achs	ACH's
Acis	ACI's
acls	ACLS
ACMs	ACM's
AcpA	ACPA
AcpB	ACPB
acq	ACQ
A&CR	A and CR
AcSOC	ACSOC
acu	ACU
AC&W	AC and W
Acy	ACY
A&D	A and D
Adab	ADAB
A. D.	AD
A.D.	AD
A.D.A.M.	adam
AdaSL	ADASL
AdC	ADC
ADCs	ADC's
AD&D	AD and D
AdK	ADK
Adl	ADL
ADLs	ADL's
adm	ADM
Adm	ADM
admn	ADMN
ADNs	ADN's
AdP	ADP
ADRs	ADR's
ADSRs	ADSR's
ADSs	ADS's
Adwa	ADWA
A&E	A and E
A. E.	AE
A.E.	AE
Aed	AED
aegte	AEGTE
Aeka	AEKA
ael	AEL
Aema	AEMA
aen	AEN
aere	AERE
AEre	AERE
AErn	AERN
Aert	AERT
Aes	AE's
aet	AET
Afa	AFA
af	AF
Af	AF
A. F.	AF
A.F.	AF
Afaf	AFAF
afc	AFC
AFCSThe	AFCSTHE
Afd	AFD
AfD	AFD
AfDB	AFDB
Afe	AFE
Aff	AFF
Afi	AFI
Afiq	AFIQ
AFMs	AFM's
AfNS	AFNS
Afo	AFO
Afr	AFR
A. G.	AG
A.G.	AG
Agco	AGCO
Agda	AGDA
AG&G	AG and G
agg	AGG
Agi	AGI
Agis	AGI's
agli	AGLI
Agn	AGN
AgN	AGN
AGNs	AGN's
AGRs	AGR's
Agsu	AGSU
agt	AGT
Agte	AGTE
Agu	AGU
A. H.	AH
A.H.	AH
Ahdhra	AHDHRA
ahe	AHE
Ahe	AHE
Ahirs	AHIR's
Ahk	AHK
Ahsa'i	AHSAI
Ahta	AHTA
aht	AHT
Ahu	AHU
Ahva	AHVA
A&I	A and I
A. I.	AI
A.I.	AI
Aias	AIA's
aici	AICI
Aicme	AICME
AICs	AIC's
Aiel	AIEL
Aife	AIFE
AiG	AIG
Aigis	AIGI's
Aija	AIJA
Aik	AIK
AIs	AI's
Aist	AIST
Aitu	AITU
Aiud	AIUD
aius	AIUS
A. J.	AJ
A.J.	AJ
Ajba	AJBA
Ajmi	AJMI
Ajok	AJOK
Ajsa	AJSA
Aju	AJU
Akaa	AKAA
a.k.a.	AKA
aka.	AKA
aka	AKA
Aka.	AKA
Aka	AKA
A&K	A and K
A. K.	AK
A.K.	AK
AKAPs	AKAP's
akas	AKA's
AKAs	AKA's
akh	AKH
Akpa	AKPA
Aku	AKU
A&L	A and L
A. L.	AL
A.L.	AL
Alh	ALH
ALUs	ALU's
A'ma	AMA
A&M	A and M
a.m.	AM
a.m	AM
A. M.	AM
A.M.	AM
AMAs	AMA's
amb	AMB
Amb	AMB
AmBX	AMBX
AMCs	AMC's
Amda	AMDA
Amd	AMD
AM&FM	AM and FM
Amha	AMHA
aml	AML
Amli	AMLI
Amlwch	AMLWCH
Amm	AMM
AM&O	AM and O
Ampt	AMPT
amr	AMR
A&M's	A and M's
Ams'	AM's
amsl	AMSL
Amta	AMTA
amt	AMT
Amt	AMT
Amts	AMT's
Amu	AMU
A. N.	AN
A.N.	AN
andFHL	ANDFHL
andPPP	ANDPPP
Anej	ANEJ
Angti	ANGTI
Angu	ANGU
Anhe	ANHE
Anr	ANR
Anrep	ANREP
A&O	A and O
A. O.	AO
A.O.	AO
AOCCs	AOCC's
Aodh	AODH
Aodla	AODLA
Aogo	AOGO
Aoke	AOKE
Aoko	AOKO
Aola	AOLA
Aol	AOL
Aone	AONE
Aoni	AONI
Aoos	AOO's
aor	AOR
AORs	AOR's
aos	AOS
AoS	AOS
Aotus	AOTU's
aov	AOV
aovf	AOVF
A&P	A and P
A. P.	AP
A.P.	AP
Apc	APC
APCh	APCH
APCs	APC's
apg	APG
Aph	APH
Apiao	APIAO
Api	API
APi	API
Apic	APIC
APICv	APICV
Apl	APL
Aplu	APLU
Apphttp	APPHTTP
Appl	APPL
appr	APPR
Appts	APPT's
appu	APPU
Appu	APPU
A&P's	A and P's
Aps	AP's
APs	AP's
AP&T	AP and T
Aqa	AQA
Aql	AQL
Aqr	AQR
A&R	A and R
A. R.	AR
A.R.	AR
ArgR	ARGR
ARGs	ARG's
ArH	ARH
ARMv	ARMV
Arnd	ARND
arv	ARV
Arv	ARV
Arwi	ARWI
As'ad	ASAD
Asai	ASAI
Asao	ASAO
A.s	A's
A. S.	AS
A.S.	AS
Asasp	ASASP
asbl	ASBL
asci	ASCI
Asci	ASCI
Asdis	ASDI's
Asfi	ASFI
Asn	ASN
Aso	ASO
Aspe	ASPE
Asr	ASR
Assn	ASSN
assoc	ASSOC
Assoc	ASSOC
ASSPs	ASSP's
Asst	ASST
Aste	ASTE
Astt	ASTT
Aswa	ASWA
A&T	A and T
atac	ATAC
Atac	ATAC
Atad	ATAD
Ata's	ATA's
Atas	ATA's
A. T.	AT
A.T.	AT
ATBs	ATB's
atc	ATC
atcc	ATCC
Atg	ATG
ath	ATH
Ath	ATH
Atia's	ATIA's
Ati	ATI
ATi	ATI
Atid	ATID
Atiiq	ATIIQ
Atil	ATIL
Atiq	ATIQ
Ativ	ATIV
Atka	ATKA
Atl	ATL
Atli	ATLI
atm	ATM
Atm	ATM
ATMs	ATM's
Atos	ATO's
ATOs	ATO's
atpB	ATPB
atri	ATRI
Atri	ATRI
A&T's	A and T's
A.T.s	AT's
AT&SF	AT and SF
AT&T	AT and T
attd	ATTD
AT&T's	AT and T's
atv	ATV
ATVs	ATV's
AtxA	ATXA
A. U.	AU
A.U.	AU
Aub	AUB
Aubl	AUBL
AUVs	AUV's
Auw	AUW
avab	AVAB
A. V.	AV
A.V.	AV
AVCs	AVC's
avg	AVG
Avn	AVN
Avo	AVO
AvP	AVP
AVRs	AVR's
Avs'	AV's
Avs	AV's
avvo	AVVO
Awa	AWA
AWAs	AWA's
A. W.	AW
A.W.	AW
Awo	AWO
Awwa	AWWA
A. X.	AX
A. Y.	AY
A.Y.	AY
A. Z.	AZ
A.Z.	AZ
Azg	AZG
Azi	AZI
azm	AZM
AzTV	AZTV
Baad	BAAD
Ba'al	BAAL
Baal	BAAL
Baam	BAAM
Baap	BAAP
ba'as	BAA's
Baat	BAAT
Ba'ath	BAATH
B. A.	BA
B.A.	BA
B&A	B and A
Bac	BAC
bae	BAE
Bae	BAE
BAe	BAE
Bauw	BAUW
B'Av	BAV
B&B	B and B
bb	BB
B. B.	BB
B.B.	BB
bbc	BBC
BB&CI	BB and CI
BBC&PJR	BBC and PJR
BBQ'er	BBQER
B&Bs	B and B's
BB&S	BB and S
BBSes	BBSE's
BB&T	BB and T
BbvCI	BBVCI
bc	BC
B. C.	BC
B.C.	BC
Bcci	BCCI
B.C.'s	BC's
BCs	BC's
BCSic	BCSIC
BdA	BDA
bd	BD
B. D.	BD
B.D.	BD
Bde	BDE
bds	BDS
BdU	BDU
B. E.	BE
B.E.	BE
Bedw	BEDW
bef	BEF
bei	BEI
Bei	BEI
Beih	BEIH
Beis	BEI's
bej	BEJ
BEMs	BEM's
Ber	BER
Bes	BE's
bf	BF
B. F.	BF
B.F.	BF
BFFs	BFF's
bfy	BFY
B. G.	BG
B.G.	BG
BglII	BGLII
bgs	BGS
Bgy	BGY
Bha	BHA
B&H	B and H
B. H.	BH
B.H.	BH
BH&E	BH and E
Bhe	BHE
BHMs	BHM's
bhttp	BHTTP
B. I.	BI
B.I.	BI
Bie	BIE
biedt	BIEDT
Biem	BIEM
B.I.G.'s	BIG's
BiH	BIH
B. J.	BJ
B.J.	BJ
BJPs	BJP's
B.J.'s	BJ's
B&K	B and K
B. K.	BK
B.K.	BK
BKCa	BKCA
B. L.	BL
B.L.	BL
ble	BLE
bleg	BLEG
blev	BLEV
bli	BLI
Blla	BLLA
BLR&D	BLR and D
BLTs	BLT's
B&M	B and M
B. M.	BM
B.M.	BM
bmd	BMD
bmi	BMI
BMPs	BMP's
BMRs	BMR's
bmt	BMT
B&N	B and N
bnb	BNB
B. N.	BN
B.N.	BN
Boac	BOAC
B&O	B and O
B. O.	BO
B.O.	BO
Boc	BOC
BoC	BOC
BOCs	BOC's
boj	BOJ
Boj	BOJ
B&O's	B and O's
bp	BP
B. P.	BP
B.P.	BP
bpl	BPL
B&Q	B and Q
B. Q.	BQ
Brbic	BRBIC
B. R.	BR
B.R.	BR
BRBs	BRB's
Brne	BRNE
Brno	BRNO
BRTs	BRT's
Brza	BRZA
brzu	BRZU
brzy	BRZY
Brzyk	BRZYK
BsaL	BSAL
B. s	B's
B.'s	B's
Bs	B's
B. S.	BS
B.S.	BS
bsd	BSD
bt	BT
B. T.	BT
B.T.	BT
Btry	BTRY
btsan	BTSAN
btus	BTUS
BTUs	BTU's
B.U.	BU
B. V.	BV
B.V.	BV
Bwa	BWA
B&W	B and W
B. W.	BW
B.W.	BW
BWTs	BWT's
bwwtv	BWWTV
Bxa	BXA
Bxe	BXE
B. Y.	BY
byc	BYC
bygd	BYGD
Byk	BYK
byn	BYN
Byo	BYO
Byou	BYOU
Byrl	BYRL
bySLC	BYSLC
byt	BYT
B.Z.	BZ
bzhed	BZHED
Bzik	BZIK
Bzyb	BZYB
Caat	CAAT
C. A.	CA
C.A.	CA
C&A	C and A
CA&CC	CA and CC
Cadw	CADW
caeca	CAECA
Cae	CAE
C.A.M.'s	CAM's
Capt.	captain
cas	CAS
Cas	CA's
Casc	CASC
cb	CB
C. B.	CB
C.B.	CB
cbc	CBC
CB&CNS	CB and CNS
CBDs	CBD's
CBGBs	CBGB's
CbiXS	CBIXS
CB&Q	CB and Q
CBs	CB's
'c	C
CcaA	CCAA
cca	CCA
Cca	CCA
C&C	C and C
C. C.	CC
C.C.	CC
ccd	CCD
CCDev	CCDEV
CCDs	CCD's
CCEd	CCED
CCi	CCI
ccm	CCM
CCRCs	CCRC's
cct	CCT
ccus	CCUS
C&D	C and D
cdc	CDC
cd	CD
C. D.	CD
C.D.	CD
CD&DR	CD and DR
CDi	CDI
cDNA	CDNA
cdnas	CDNAS
cDNAs	CDNA's
CDOs	CDO's
CDPs	CDP's
CD&R	CD and R
cds	CDS
CDs	CD's
CDSPCo	CDSPCO
CdtA	CDTA
CdTe	CDTE
CDTi	CDTI
CD&V	CD and V
Cec	CEC
c'e	CE
ce	CE
C'e	CE
Ce	CE
C. E.	CE
C.E.	CE
Ceel	CEEL
Cefn	CEFN
C&EI's	C and EI's
C&EN	C and EN
cen	CEN
Cen	CEN
ceo	CEO
Ceol	CEOL
Ceorl	CEORL
Ceos	CEO's
CEOs'	CEO's
CEOs	CEO's
cer	CER
Cer	CER
ces	CES
Ces	CE's
Cex	CEX
CeX	CEX
Cfa	CFA
C&F	C and F
cf	CF
C. F.	CF
C.F.	CF
CFOs	CFO's
CFTs	CFT's
C&G	C and G
C. G.	CG
C.G.	CG
cgl	CGL
C&H	C and H
C. H.	CH
C.H.	CH
Chhu	CHHU
Chirs	CHIR's
CHP'den	CHPDEN
CHPs	CHP's
Chy	CHY
Cia	CIA
ci	CI
Ci	CI
C. I.	CI
C.I.	CI
Cicic	CICIC
cii	CII
cim	CIM
Cim	CIM
Cio	CIO
CIOs	CIO's
Cip	CIP
cis	CIS
CIs	CI's
cit	CIT
CiTD	CITD
citS	CITS
CitX	CITX
Ciuc	CIUC
Ciu	CIU
CiU	CIU
Cixi	CIXI
C. J.	CJ
C.J.	CJ
C. K.	CK
C.K.	CK
ckx	CKX
CLBs	CLB's
clc	CLC
cl	CL
C. L.	CL
C.L.	CL
Cle	CLE
cllr	CLLR
CL&N	CL and N
Clo	CLO
CL&P	CL and P
CLs	CL's
CLTs	CLT's
Clu	CLU
Clwyd	CLWYD
C&MA	C and MA
cm	CM
C. M.	CM
C.M.	CM
CMCs	CMC's
Cmde	CMDE
cmdr	CMDR
cml	CML
CMMs	CMM's
cmn	CMN
Cmte	CMTE
cn	CN
C. N.	CN
C.N.	CN
CNMs	CNM's
cnr	CNR
CNs	CN's
CNTs	CNT's
Cnut's	CNUT's
CNVs	CNV's
C&O	C and O
C. O.	CO
C.O.	CO
Co.	company
Col.	colonel
C&P	C and P
cp	CP
C. P.	CP
C.P.	CP
CPCs	CPC's
cpo	CPO
CPUs	CPU's
cq	CQ
CQDs	CQD's
cr	CR
C. R.	CR
C.R.	CR
Cre	CRE
crk	CRK
Crkva	CRKVA
crkve	CRKVE
CRLs	CRL's
crm	CRM
Crne	CRNE
Crni	CRNI
Crno	CRNO
CRs	CR's
csa	CSA
Csa	CSA
Csak	CSAK
Csaky	CSAKY
C&S	C and S
cs	CS
C.s	C's
Cs	C's
C. S.	CS
C.S.	CS
C&SF	C and SF
csg	CSG
CsI	CSI
CSis	CSI's
CSIs	CSI's
CSOs	CSO's
cspA	CSPA
csp	CSP
CSPs	CSP's
CSSNCs	CSSNC's
Csuz	CSUZ
CTAs	CTA's
C&T	C and T
cte	CTE
CTLs	CTL's
ctr	CTR
Ctrip	CTRIP
ctv	CTV
cu	CU
C. U.	CU
Cuyp	CUYP
C&V	C and V
cvcp	CVCP
'cv	CV
cv	CV
C. V.	CV
C.V.	CV
CVEs	CVE's
CVOs	CVO's
CVs	CV's
CVTs	CVT's
C. W.	CW
C.W.	CW
Cwej	CWEJ
Cwele	CWELE
cwm	CWM
cwrt	CWRT
C.X.	CX
C. Y.	CY
C.Y.	CY
cyl	CYL
Cyn	CYN
CyP	CYP
Cyrl	CYRL
Cys	CY's
czci	CZCI
cz	CZ
C.Z.	CZ
czy	CZY
Daai	DAAI
D. A.	DA
D.A.	DA
D&AD	D and AD
D.A.N.C.E.	dance
Dav	DAV
dBa	DBA
db	DB
D. B.	DB
D.B.	DB
DCCs	DCC's
D&C	D and C
dc	DC
D. C.	DC
D.C.	DC
DCom	DCOM
D.C.'s	DC's
DCs	DC's
DCUs	DCU's
D&D	D and D
D. D.	DD
D.D.	DD
DDi	DDI
Ddoc	DDOC
Ddu	DDU
Deah	DEAH
D. E.	DE
D.E.	DE
deg	DEG
dei	DEI
Dei	DEI
DeI	DEI
Deijm	DEIJM
Deip	DEIP
dez	DEZ
Dez	DEZ
Dfa	DFA
DFCs	DFC's
D. F.	DF
D.F.	DF
DfE	DFE
DfES	DFES
DFPs	DFP's
DFs	DF's
dfx	DFX
D&G	D and G
D. G.	DG
D.G.	DG
Dha	DHA
DHBs	DHB's
D&H	D and H
dh	DH
D. H.	DH
D.H.	DH
d'HEC	DHEC
dhe	DHE
Dheku	DHEKU
Dhod	DHOD
dhol	DHOL
Dhol	DHOL
Dhoo	DHOO
Dhor	DHOR
Dhou	DHOU
dhr	DHR
DHSs	DHS's
D.I.	DI
diy	DIY
DiY	DIY
Diyn	DIYN
DIYs	DIY's
Djam	DJAM
dj	DJ
D. J.	DJ
D.J.	DJ
DJ'ed	DJED
Djem	DJEM
Dji	DJI
Djo	DJO
D'Jok	DJOK
djr	DJR
D.J.s	DJ's
DJs	DJ's
DjVu	DJVU
DjVus	DJVU's
D. K.	DK
D.K.	DK
dla	DLA
dl	DL
D. L.	DL
D.L.	DL
dlia	DLIA
DL&LR	DL and LR
DLLs	DLL's
dlo	DLO
DL&W	DL and W
D.M.C.'s	DMC's
D&M	D and M
D. M.	DM
D.M.	DM
DMed	DMED
DM&E	DM and E
DMs	DM's
DMUs	DMU's
Dna	DNA
DnA	DNA
DnaJ	DNAJ
D. N.	DN
D.N.	DN
Dnepr	DNEPR
dnes	DNES
Dnes	DNE's
DNFs	DNF's
DNSBLs	DNSBL's
dns	DNS
D.O.A.'s	DOA's
dod	DOD
Dod	DOD
DoD	DOD
D. O.	DO
D.O.	DO
D'oh	DOH
dok	DOK
Dok	DOK
domt	DOMT
Domt	DOMT
Dop	DOP
dotCMS	DOTCMS
DotSVN	DOTSVN
Douw	DOUW
dozd	DOZD
d'OZ	DOZ
Dozhd	DOZHD
dp	DP
D. P.	DP
D.P.	DP
dpon	DPON
DProf	DPROF
DPs	DP's
D.Q.	DQ
drc	DRC
Dr.	doctor
D. R.	DR
D.R.	DR
dri	DRI
Dri	DRI
DRIs	DRI's
Driu	DRIU
Driv	DRIV
Drnis	DRNI's
Dro	DRO
Drs.	doctors
Drska	DRSKA
druj	DRUJ
DsbA	DSBA
DS&BB	DS and BB
dsDNA	DSDNA
ds	DS
Ds	D's
D. S.	DS
D.S.	DS
DSGi	DSGI
dsi	DSI
DSi	DSI
dsl	DSL
DSMs	DSM's
dsn	DSN
D&SNGRR	D and SNGRR
dsu'	DSU
DTCs	DTC's
DTDs	DTD's
D. T.	DT
D.T.	DT
DT&E	DT and E
DT&I	DT and I
dtl	DTL
DTs	DT's
dty	DTY
D.U.	DU
dva	DVA
Dva	DVA
DVCs	DVC's
dvd	DVD
DVDs	DVD's
dv	DV
D. V.	DV
D.V.	DV
dve	DVE
dvfb	DVFB
dvi	DVI
dvije	DVIJE
Dvin	DVIN
Dvir	DVIR
Dwa	DWA
D&W	D and W
D. W.	DW
D.W.	DW
Dwedw	DWEDW
Dwi	DWI
dwr	DWR
dwur	DWUR
dxa	DXA
dx	DX
D.X.	DX
DXers	DXER's
Dydd	DYDD
dy	DY
Dy	DY
D. Y.	DY
dypl	DYPL
dyr	DYR
dz	DZ
dzis	DZIS
Dzog	DZOG
Dzor	DZOR
Dzus	DZU's
E. A.	EA
E.A.	EA
EAMs	EAM's
eas	EAS
Eas	EA's
Eav	EAV
E. B.	EB
E.B.	EB
Ebn	EBN
E&BR	E and BR
Ebru	EBRU
EBWs	EBW's
ecc	ECC
Eccl	ECCL
ec	EC
Ec	EC
E. C.	EC
E.C.	EC
ece	ECE
Ece	ECE
Ecem	ECEM
ecg	ECG
ecma	ECMA
ECNs	ECN's
ECP&DA's	ECP and DA's
eCRM	ECRM
ect	ECT
ECVs	ECV's
edb	EDB
E. D.	ED
E.D.	ED
Edh	EDH
edhe	EDHE
EDMs	EDM's
Edmx	EDMX
edn	EDN
Edn	EDN
eds	EDS
Eds	ED's
Edw	EDW
Eeb	EEB
E. E.	EE
E.E.	EE
Eef	EEF
Eega	EEGA
eene	EENE
eep	EEP
Ees	EE's
eeuw	EEUW
Eeuw	EEUW
EEZs	EEZ's
efc	EFC
ef	EF
Ef	EF
E. F.	EF
E.F.	EF
eFS	EFS
Efs	EF's
Efu	EFU
Egba	EGBA
egfl	EGFL
e.g.	for  example
e. g.	for  example
EG&G	EG and G
Egi	EGI
E&GR	E and GR
egy	EGY
Egyl	EGYL
EHAs	EHA's
E. H.	EH
E.H.	EH
ehf	EHF
Ehttp	EHTTP
EiCs	EIC's
E. I.	EI
E.I.	EI
eIF	EIF
Eitr	EITR
EITs	EIT's
EJBs	EJB's
ej	EJ
E. J.	EJ
E.J.	EJ
E. K.	EK
E.K.	EK
eki	EKI
Ekma	EKMA
Ekow	EKOW
eks	EKS
Eks	EK's
E. L.	EL
E.L.	EL
ELTs	ELT's
ELUs	ELU's
Embd	EMBD
eMC	EMC
EMDs	EMD's
Emea	EMEA
E&M	E and M
E. M.	EM
E.M.	EM
Emge	EMGE
emra	EMRA
E&NA	E and NA
Enas	ENA's
EnBW	ENBW
EncFS	ENCFS
Encyc	ENCYC
E. N.	EN
E.N.	EN
Enes	ENE's
engl	ENGL
Engl	ENGL
Engr	ENGR
Eni	ENI
enn	ENN
Enn	ENN
ens	ENS
Ens	EN's
Enso	ENSO
ENTJs	ENTJ's
EoD	EOD
E. O.	EO
E.O.	EO
Eois	EOI's
eok	EOK
Eole	EOLE
Eol	EOL
Eolss	EOLS's
Eom	EOM
eop	EOP
eoptta	EOPTTA
Eora	EORA
Eorl	EORL
Eors	EOR's
E&P	E and P
Epe	EPE
ep	EP
Ep	EP
E. P.	EP
E.P.	EP
Eph	EPH
Ephs	EPH's
epi	EPI
Epi	EPI
ePO	EPO
epos'	EPO's
epos	EPOS
Epos	EPO's
E.P.s	EP's
eq	EQ
Eq	EQ
E. R.	ER
E.R.	ER
ERJs	ERJ's
Eru	ERU
Eruv	ERUV
Erv	ERV
ES3	ES three
Esa	ESA
Esam	ESAM
Esa's	ESA's
Esat	ESAT
ESCs	ESC's
Esd	ESD
E. S.	ES
E.S.	ES
esi	ESI
espn	ESPN
ESPNhttp	ESPNHTTP
esq	ESQ
Esq	ESQ
Esq.	esquire
Esraa	ESRAA
Esra	ESRA
Esref	ESREF
Esri	ESRI
estd	ESTD
Estd	ESTD
esu	ESU
Esva	ESVA
Etad	ETAD
ETBs	ETB's
E. T.	ET
E.T.	ET
ETFs	ETF's
Et'hem	ETHEM
Eti	ETI
etj	ETJ
Eto	ETO
ets	ETS
Ets	ET's
ETs	ET's
ett	ETT
Ett	ETT
Ettre	ETTRE
Etts	ETT's
Etz	ETZ
EUBs	EUB's
E. U.	EU
E.U.	EU
eup	EUP
Eurwg	EURWG
Euse	EUSE
Eusi	EUSI
EvaGT	EVAGT
E. V.	EV
E.V.	EV
evl	EVL
Evna	EVNA
evnt	EVNT
EVs	EV's
evv	EVV
Ewa's	EWA's
E. W.	EW
E.W.	EW
Ewha	EWHA
EWOs	EWO's
Ewu	EWU
excl	EXCL
exd	EXD
E.X.	EX
exhb	EXHB
exh	EXH
Exptl	EXPTL
exsul	EXSUL
E&Y	E and Y
E. Y.	EY
Eyk	EYK
eyu	EYU
Ezaa	EZAA
ez	EZ
Ez	EZ
Ezh	EZH
Ezu	EZU
Ezy	EZY
Faaa	FAAA
faa	FAA
Faa	FAA
faama	FAAMA
FabH	FABH
FabR	FABR
F.A.B.'s	FAB's
Fadl	FADL
fa	FA
Fa	FA
F. A.	FA
F.A.	FA
Faf	FAF
Fafhrd	FAFHRD
fai	FAI
Fai	FAI
FAIPs	FAIP's
Faiq	FAIQ
fajn	FAJN
Fal	FAL
farw	FARW
fasc	FASC
Fasc	FASC
fas	FAS
Fas	FA's
FAs	FA's
FasL	FASL
F. B.	FB
F.B.	FB
F.B.G.s	FBG's
FBOs	FBO's
fcb	FCB
FCBs	FCB's
F&C	F and C
fc	FC
F. C.	FC
F.C.	FC
F.C.'s	FC's
FD&C	FD and C
FDCPAs	FDCPA's
F. D.	FD
F.D.	FD
FDICs	FDIC's
FdI	FDI
F. E.	FE
F.E.	FE
FEGs	FEG's
Fes	FE's
ffc	FFC
ff	FF
F. F.	FF
F.F.	FF
ffm	FFM
FFs	FF's
F. G.	FG
F.G.	FG
fgk	FGK
FGs	FG's
F. H.	FH
F.H.	FH
fhm	FHM
fiadh	FIADH
fia	FIA
FiBL	FIBL
Fi'd	FID
F.I	F
F&I	F and I
F. I.	FI
F.I.	FI
Figl	FIGL
fija	FIJA
Fio	FIO
FiO	FIO
F. J.	FJ
F.J.	FJ
F. K.	FK
F.K.	FK
Fla	FLA
Fles	FLE's
fl	FL
F. L.	FL
F.L.	FL
fli	FLI
flyr	FLYR
fm	FM
F. M.	FM
F.M.	FM
fMRI	FMRI
FMs	FM's
F. N.	FN
F.N.	FN
F. O.	FO
FPDs	FPD's
fp	FP
F. P.	FP
F.P.	FP
FPGAs	FPGA's
FPM&SA	FPM and SA
fps	FPS
FPSs	FPS's
F.Q.	FQ
fr	FR
F. R.	FR
F.R.	FR
frs	FRS
Fru	FRU
Frwydr	FRWYDR
fsf	FSF
fs	FS
F. s	F's
Fs	F's
F. S.	FS
F.S.	FS
fsn	FSN
FSSs	FSS's
FTAs	FTA's
Ft.	Fort
F. T.	FT
F.T.	FT
ftp	FTP
FtsA	FTSA
Ftuh	FTUH
F. V.	FV
F.V.	FV
F&W	F and W
F. W.	FW
F.W.	FW
fwr	FWR
fx	FX
Fyb	FYB
F.Y.	FY
Fyn	FYN
fyi	FYI
fyr	FYR
Fyw	FYW
F.Z.	FZ
Gaac	GAAC
G. A.	GA
G.A.	GA
Gbe	GBE
GbE	GBE
G. B.	GB
G.B.	GB
GB&NDR	GB and NDR
G&C	G and C
G. C.	GC
G.C.	GC
GCSEs	GCSE's
GC&SF	GC and SF
Gdal	GDAL
Gde	GDE
gd	GD
G. D.	GD
G.D.	GD
Gdow	GDOW
GDPs	GDP's
gdr	GDR
Gebr	GEBR
Gebt	GEBT
Ged	GED
ge	GE
G. E.	GE
G.E.	GE
Gek	GEK
Gen.	general
geq	GEQ
Geu	GEU
Gev	GEV
GeV	GEV
Gfa	GFA
GF&A	GF and A
G. F.	GF
G.F.	GF
G. G.	GG
G.G.	GG
Ghe	GHE
G. H.	GH
G.H.	GH
GHGs	GHG's
Ghir	GHIR
ghra	GHRA
GH&SA	GH and SA
Giei	GIEI
G. I.	GI
G.I.	GI
G. J.	GJ
G.J.	GJ
G. K.	GK
G.K.	GK
Gla	GLA
G&L	G and L
G. L.	GL
G.L.	GL
gli	GLI
Gli	GLI
Glis	GLI's
glnA	GLNA
Glos	GLO's
gma	GMA
GmbH	GMBH
Gmel	GMEL
gm	GM
G. M.	GM
G.M.	GM
gmin	GMIN
GMOs	GMO's
GMs	GM's
gmt	GMT
Gmul	GMUL
gnb	GNB
G. N.	GN
G.N.	GN
GNP&BR	GNP and BR
gnp	GNP
GNPs	GNP's
G.O.	GO
GPCRs	GPCR's
GPdI	GPDI
G&P	G and P
gp	GP
G. P.	GP
G.P.	GP
GpIIb	GPIIB
GPMGs	GPMG's
GPRs	GPR's
GPUs	GPU's
G. Q.	GQ
grac	GRAC
gra	GRA
Gra	GRA
Grbac	GRBAC
GRBs	GRB's
grc	GRC
GRCs	GRC's
gre	GRE
Gre	GRE
gr	GR
G. R.	GR
G.R.	GR
grrl	GRRL
Gryf	GRYF
gry	GRY
Gry	GRY
grz	GRZ
G&S	G and S
Gs	G's
G. S.	GS
G.S.	GS
GSIs	GSI's
GSOp	GSOP
GTAs	GTA's
gt	GT
G. T.	GT
G.T.	GT
GTi	GTI
GTs	GT's
G. U.	GU
G.U.	GU
GUIs	GUI's
G. V.	GV
G.V.	GV
GvpA	GVPA
GWe	GWE
Gwet	GWET
gw	GW
G. W.	GW
G.W.	GW
Gwi	GWI
gwr	GWR
Gy	GY
G. Y.	GY
Gyn	GYN
Gyps	GYP's
gyu	GYU
Gyu	GYU
H. A.	HA
H.A.	HA
H&A	H and A
HBCo	HBCO
HBGAs	HBGA's
H. B.	HB
H.B.	HB
H&BR	H and BR
HCEs	HCE's
H. C.	HC
H.C.	HC
hcl	HCL
HClO	HCLO
HCoV	HCOV
HCPs	HCP's
Hcy	HCY
Hdad	HDAD
hDAF	HDAF
HDDs	HDD's
hd	HD
H. D.	HD
H.D.	HD
hdh	HDH
HDi	HDI
H. E.	HE
H.E.	HE
hezb	HEZB
Hezb	HEZB
H&F	H and F
H. F.	HF
H.F.	HF
hgcA	HGCA
hg	HG
H. G.	HG
H.G.	HG
HgO	HGO
HGPs	HGP's
HgU	HGU
HGVs	HGV's
H&H	H and H
H. H.	HH
H.H.	HH
H. I.	HI
H.I.	HI
Hizb	HIZB
hja	HJA
H. J.	HJ
H.J.	HJ
Hkam	HKAM
H&K	H and K
H. K.	HK
H.K.	HK
Hla	HLA
H. L.	HL
H.L.	HL
Hluk	HLUK
hlutr	HLUTR
Hly	HLY
Hman	HMAN
H&M	H and M
hm	HM
H. M.	HM
H.M.	HM
HMOs	HMO's
hMRE	HMRE
H&M's	H and M's
H. N.	HN
H.N.	HN
H. O.	HO
H.O.	HO
hpc	HPC
hp	HP
H. P.	HP
H.P.	HP
H.Q.	HQ
H&R	H and R
H. R.	HR
H.R.	HR
hroa	HROA
HRo	HRO
hrs	HRS
HRs	HR's
hscy	HSCY
Hsee	HSEE
hs	HS
Hs	H's
H. S.	HS
H.S.	HS
hsi	HSI
hSlo	HSLO
HSPs	HSP's
HSTs	HST's
hsv	HSV
hTAS	HTAS
HTAs	HTA's
htc	HTC
ht	HT
H. T.	HT
H.T.	HT
hti	HTI
Htin	HTIN
Htoo	HTOO
HtrA	HTRA
HTRs	HTR's
http	HTTP
https	HTTPS
Htwa	HTWA
H. U.	HU
HVCs	HVC's
hvcv	HVCV
hvem	HVEM
Hvem	HVEM
H. V.	HV
H.V.	HV
H. W.	HW
H.W.	HW
hwy	HWY
Hwy	HWY
hxt	HXT
H. Y.	HY
H.Y.	HY
H. Z.	HZ
HZ&PC	HZ and PC
iaaf	IAAF
IaaS	IAAS
Iaca	IACA
Iacob	IACOB
IACTs	IACT's
Iacub	IACUB
iagt	IAGT
I. A.	IA
I.A.	IA
Iapa	IAPA
iar	IAR
Iar	IAR
IAUCs	IAUC's
Iax	IAX
Ibac	IBAC
Ibaes	IBAE's
IBCs	IBC's
IBDA'A	IBDAA
Ibda	IBDA
ibdal	IBDAL
I. B.	IB
I.B.	IB
Ibm	IBM
Ibne	IBNE
ibn	IBN
Ibra	IBRA
Ibsa	IBSA
Ibs	IB's
iBT	IBT
Ibu	IBU
iby	IBY
ICBMs	ICBM's
Icche	ICCHE
icf	ICF
I&C	I and C
ic	IC
Ic	IC
I. C.	IC
I.C.	IC
Ici	ICI
iCN	ICN
Ico	ICO
IcRn	ICRN
ics	ICS
ICs	IC's
ICTs	ICT's
ICTVdB	ICTVDB
ICv	ICV
iCyt	ICYT
Iddaa	IDDAA
Idd	IDD
ID'd	IDD
id	ID
I. D.	ID
I.D.	ID
Idi	IDI
Idir	IDIR
IDLHs	IDLH's
Idm	IDM
IDPs	IDP's
ids	IDS
IDs	ID's
IDx	IDX
i.e.	that  is
Ifa	IFA
ifc	IFC
IfF	IFF
Ifft	IFFT
ifi	IFI
Ifi	IFI
IFIs	IFI's
IfM	IFM
Ifni	IFNI
IFNs	IFN's
Ifop	IFOP
IFRSs	IFRS's
Iga	IGA
IgA	IGA
IGFs	IGF's
'ig	IG
Ig	IG
I.G.	IG
igi	IGI
IgM	IGM
ign	IGN
Ign	IGN
Ih	IH
I. H.	IH
ihi	IHI
ihm	IHM
ihn	IHN
Ihn	IHN
Ihor	IHOR
Iht	IHT
IIb	IIB
IIc	IIC
IIfx	IIFX
Iiga	IIGA
IIga	IIGA
IIgs	IIG's
IIGs	IIG's
IIIb	IIIB
IIIBy	IIIBY
IIIc	IIIC
IIId	IIID
I. I.	II
I.I.	II
ija	IJA
Ija	IJA
ij	IJ
I. J.	IJ
Ijok	IJOK
Ijui	IJUI
Ikh	IKH
I.K.	IK
IKr	IKR
Iksa	IKSA
Iku	IKU
Ilbe	ILBE
IL&FS	IL and FS
ili	ILI
Ili	ILI
I. L.	IL
I.L.	IL
Ilm	ILM
ilu	ILU
Ilu	ILU
IMbd	IMBD
imc	IMC
imdb	IMDB
IMDb.	IMDB
IMDb	IMDB
ime	IME
I&M	I and M
I. M.	IM
I.M.	IM
Iml	IML
Imm	IMM
Imms'	IMM's
imoa	IMOA
impr	IMPR
Impr	IMPR
iMSNs	IMSN's
Imst	IMST
Inba	INBA
inb	INB
incl	INCL
ind	IND
Ind	IND
Infs	INF's
inHg	INHG
I. N.	IN
I.N.	IN
InlB	INLB
InP	INP
Inre	INRE
Inspx	INSPX
Ints	INT's
INTs	INT's
Intu	INTU
inv	INV
Ioba	IOBA
IODs	IOD's
io.	IO
io	IO
.I.o.	IO
Io.	IO
Io	IO
.IO	IO
I/O	IO
Ioka	IOKA
Iok	IOK
IoM	IOM
IOPs	IOP's
iOS	IOS
Io's	IO's
I/Os	IO's
I.O.'s	IO's
Iosu	IOSU
IoT	IOT
IoW	IOW
IPCs	IPC's
ip	IP
Ip	IP
I.P.	IP
Ipo	IPO
IPPs	IPP's
Ippu	IPPU
iPPV	IPPV
iPSC	IPSC
iPSCs	IPSC's
ipse	IPSE
iPS	IPS
IPs	IP's
IPv	IPV
iQ	IQ
I.Q.	IQ
Irgm	IRGM
Irig	IRIG
Iril	IRIL
i'r	IR
ir	IR
Ir	IR
I. R.	IR
I.R.	IR
Irla	IRLA
Irmis	IRMI's
iro	IRO
Iro	IRO
Irra	IRRA
IRs	IR's
iru	IRU
Iru	IRU
ISAv	ISAV
Isba	ISBA
isbn	ISBN
ISBNs	ISBN's
isCf	ISCF
iSC	ISC
Isc	ISC
Isd	ISD
isdn	ISDN
Isgec	ISGEC
ishq	ISHQ
Ishq	ISHQ
I. S.	IS
I.S.	IS
Isl	ISL
ISMNs	ISMN's
ISPs	ISP's
Isra'il	ISRAIL
Isra	ISRA
iss	ISS
Iss	IS's
ISSNs	ISSN's
Isu	ISU
Ite	ITE
ITHs	ITH's
iti	ITI
Iti	ITI
I.T.	IT
itk	ITK
Itk	ITK
ITNNs	ITNN's
Itoi	ITOI
iTP	ITP
Itse	ITSE
itt	ITT
Itu	ITU
Itz	ITZ
Iucn	IUCN
IUDs	IUD's
Iuz	IUZ
I. V.	IV
I.V.	IV
IVs	IV's
Ivu	IVU
Iwas	IWA's
Iwaz	IWAZ
IWBs	IWB's
iwi	IWI
iw	IW
I. W.	IW
iwrg	IWRG
iwspy	IWSPY
Iwuh	IWUH
IXb	IXB
IXBs	IXB's
IXCs	IXC's
IXe	IXE
iXL	IXL
ixtle	IXTLE
Iya	IYA
Iyar	IYAR
iyem	IYEM
Iyi	IYI
iy	IY
I. Y.	IY
I.Y.	IY
Jaf	JAF
J. A.	JA
J&B	J and B
jb	JB
J. B.	JB
J.B.	JB
jcis	JCIS
jc	JC
J. C.	JC
J.C.	JC
JCRs	JCR's
JdeBP	JDEBP
jdi	JDI
jd	JD
J. D.	JD
J.D.	JD
jdk	JDK
J&D's	J and D's
J.D.s	JD's
J. E.	JE
J.E.	JE
jf	JF
J. F.	JF
J.F.	JF
J. G.	JG
J.G.	JG
jh	JH
J. H.	JH
J.H.	JH
JHs	JH's
JHSVs	JHSV's
JHud	JHUD
J. I.	JI
J.I.	JI
J&J	J and J
J. J.	JJ
J.J.	JJ
Jka	JKA
jkd	JKD
J&K	J and K
J. K.	JK
J.K.	JK
jkx	JKX
J. L.	JL
J.L.	JL
J. M.	JM
J.M.	JM
jnb	JNB
J. N.	JN
J.N.	JN
Jno	JNO
jnr	JNR
J. O.	JO
J.O.	JO
jpg	JPG
J&P	J and P
jp	JP
J.P.	JP
J.Q.	JQ
J&R	J and R
J. R.	JR
J.R.	JR
Jr.	junior
jr.	junior
Jr	junior
jr	junior
J.R.'s	JR's
jsb	JSB
Js	J's
J. S.	JS
J.S.	JS
J&T	J and T
J. T.	JT
J.T.	JT
JT&KW	JT and KW
J. U.	JU
J&V	J and V
J. V.	JV
J.V.	JV
Jwa	JWA
J. W.	JW
J.W.	JW
jx	JX
J. Y.	JY
J.Y.	JY
Jym	JYM
Jymn	JYMN
J. Z.	JZ
J.Z.	JZ
K. A.	KA
K.A.	KA
kbi	KBI
K&B	K and B
K. B.	KB
K.B.	KB
K. C.	KC
K.C.	KC
K.C.'s	KC's
kDa	KDA
kdal	KDAL
K&D	K and D
kd	KD
K. D.	KD
K.D.	KD
K. D.'s	KD's
K.D.'s	KD's
ke	KE
Ke	KE
K. E.	KE
K.E.	KE
kfc	KFC
K.F.	KF
kgr	KGR
kgt	KGT
KgU	KGU
kgv	KGV
Khizr	KHIZR
K. H.	KH
K.H.	KH
Khlav	KHLAV
Khmu	KHMU
Khri	KHRI
Khru	KHRU
K. I.	KI
K.I.	KI
Kjer	KJER
kj	KJ
K. J.	KJ
K.J.	KJ
Kjop	KJOP
KJo's	KJO's
K. K.	KK
K.K.	KK
Kle	KLE
kl	KL
K. L.	KL
K.L.	KL
K&M	K and M
km	KM
K. M.	KM
K.M.	KM
K&N	K and N
kn	KN
K. N.	KN
K.N.	KN
k'o	KO
K. O.	KO
K.O.	KO
KPIs	KPI's
K&P	K and P
K. P.	KP
K.P.	KP
Kppen	KPPEN
kptm	KPTM
krc	KRC
KRCs	KRC's
K.R.I.T.'s	KRIT's
Krka	KRKA
kr	KR
K. R.	KR
K.R.	KR
Krne	KRNE
kroz	KROZ
Kroz	KROZ
Kru	KRU
ksa	KSA
kset	KSET
Kseur	KSEUR
Ksevt	KSEVT
ks	KS
K. S.	KS
K.S.	KS
Ktav	KTAV
KT&K	KT and K
kt	KT
K. T.	KT
K.T.	KT
Kuaa	KUAA
Kud	KUD
kuih	KUIH
K. U.	KU
K.U.	KU
Kutb	KUTB
Kvik	KVIK
Kvit	KVIT
K. V.	KV
K.V.	KV
Kvyat	KVYAT
kwa	KWA
kwe	KWE
Kyse	KYSE
kyt	KYT
Kyt	KYT
kz	KZ
K. Z.	KZ
L. A.	LA
L.A.'s	LA's
Lay's	LAY's
LBi	LBI
L. B.	LB
L.B.	LB
LBPs	LBP's
LCAs	LCA's
lcc	LCC
LCCs	LCC's
LC&DR	LC and DR
LCDs	LCD's
LCIs	LCI's
L. C.	LC
L.C.	LC
lcn	LCN
LCSs	LCS's
LCTs	LCT's
LCVPs	LCVP's
Lda	LDA
LDCs	LDC's
L. D.	LD
L.D.	LD
L. E.	LE
L.E.	LE
LFFCs	LFFC's
L. F.	LF
L.F.	LF
LFs	LF's
LFSRs	LFSR's
L. G.	LG
L.G.	LG
LGMs	LGM's
LG&RDD	LG and RDD
LGs	LG's
LGUs	LGU's
LGVs	LGV's
Lha	LHA
L. H.	LH
L.H.	LH
L. I.	LI
L.I.	LI
Lje	LJE
L. J.	LJ
L.J.	LJ
L. K.	LK
lks	LKS
Llapi	LLAPI
lle	LLE
lli	LLI
L&L	L and L
L. L.	LL
L.L.	LL
llp	LLP
llu	LLU
LMGs	LMG's
lm	LM
L. M.	LM
L.M.	LM
LMPs	LMP's
LMQs	LMQ's
LnAIB	LNAIB
L&N	L and N
L. N.	LN
L.N.	LN
L.O.C.'s	LOC's
Lokk	LOKK
l'OL	LOL
L. O.	LO
L.O.	LO
LPARs	LPAR's
L&P	L and P
lp	LP
L. P.	LP
L.P.	LP
L&PM	L and PM
LPMud	LPMUD
LPs	LP's
LPThe	LPTHE
lr	LR
L. R.	LR
L.R.	LR
LRTs	LRT's
LRVs	LRV's
LSDs	LSD's
LSi	LSI
ls	LS
Ls	L's
L. S.	LS
L.S.	LS
LSTs	LST's
LSVCCs	LSVCC's
Ltda	LTDA
Ltd.	limited
L&T	L and T
Lt.	lieutenant
lt	LT
L. T.	LT
L.T.	LT
ltoh	LTOH
L. U.	LU
lv	LV
L. V.	LV
L.V.	LV
L. W.	LW
L.W.	LW
L.Y.	LY
L&YR	L and YR
M. A.	MA
M.A.	MA
M&A	M and A
Mbewu	MBEWU
mbi	MBI
M. B.	MB
M.B.	MB
mBo	MBO
Mbre	MBRE
mbr	MBR
MCCs	MCC's
M. C.	MC
M.C.	MC
MCs	MC's
mcyG	MCYG
mdb	MDB
MDCs	MDC's
mdDA	MDDA
MD&DI	MD and DI
Mde	MDE
MDGs	MDG's
MDHUs	MDHU's
mDia	MDIA
MDic	MDIC
mdla	MDLA
md	MD
M. D.	MD
M.D.	MD
mdr	MDR
M. E.	ME
M.E.	ME
MFDs	MFD's
MFe	MFE
M. F.	MF
M.F.	MF
MFTs	MFT's
Mgadla	MGADLA
Mgal	MGAL
mga	MGA
Mga	MGA
Mgbo	MGBO
MGen	MGEN
M&G	M and G
M. G.	MG
M.G.	MG
M&GN	M and GN
M&GR's	M and GR's
Mha	MHA
MHCs	MHC's
MH&L	MH and L
M&H	M and H
M. H.	MH
M.H.	MH
Mhor	MHOR
Mhow	MHOW
M.I.A.'s	MIA's
M&I	M and I
M. I.	MI
M.I.	MI
M&J	M and J
M. J.	MJ
M.J.	MJ
M. K.	MK
M.K.	MK
MKs	MK's
MLAs	MLA's
mlc	MLC
MLCs	MLC's
mlg	MLG
mli	MLI
Mlle	MLLE
M&L	M and L
M. L.	ML
M.L.	ML
MLPs	MLP's
MM&A	MM and A
M&M	M and M
M. M.	MM
M.M.	MM
M&M's	M and M's
MNCs	MNC's
M&NF	M and NF
M. N.	MN
M.N.	MN
M.O.G.U.E.R.A.'s	MOGUERA's
M. O.	MO
M.O.	MO
MpA	MPA
MPAs	MPA's
MPBu	MPBU
MP&I	MP and I
MPi	MPI
MPLMs	MPLM's
M&P	M and P
M. P.	MP
M.P.	MP
MPPs	MPP's
M.P.'s	MP's
MPs	MP's
MPThe	MPTHE
Mpu	MPU
M. Q.	MQ
Mra	MRA
MRBs	MRB's
mre	MRE
MR&LE	MR and LE
Mr.	mister
M. R.	MR
M.R.	MR
mRNA	MRNA
mRNAs	MRNA's
Mrs.	misses
MRTs	MRT's
msd	MSD
Mse	MSE
M&S	M and S
Ms.	miss
M. S.	MS
M.S.	MS
MSPs	MSP's
mst	MST
Mta	MTA
MTAs	MTA's
M&T	M and T
M. T.	MT
M.T.	MT
Mtor	MTOR
mtvU	MTVU
MTVu	MTVU
M. U.	MU
M.U.s	MU's
MVMs	MVM's
M. V.	MV
M.V.	MV
MVPs	MVP's
MVs	MV's
MWe	MWE
M. W.	MW
M.W.	MW
M. X.	MX
myb	MYB
myc	MYC
Myc	MYC
MyDD	MYDD
M. Y.	MY
M.Y.	MY
MySQL	MYSQL
M. Z.	MZ
N. A.	NA
N.A.	NA
N.B.A.'s	NBA's
NBAs	NBA's
N. B.	NB
N.B.	NB
nbs	NBS
NBTwo	NBTWO
NCAAs	NCAA's
NCCs	NCC's
N. C.	NC
N.C.	NC
NCOs	NCO's
N. D.	ND
N.D.	ND
N. E.	NE
N.E.	NE
ner	NER
NFATc	NFATC
nfed	NFED
N. F.	NF
N.F.	NF
Nge	NGE
N. G.	NG
N.G.	NG
NGOs	NGO's
Nha	NHA
NHCEs	NHCE's
NHCs	NHC's
nhi	NHI
NHM&W	NHM and W
N. H.	NH
N.H.	NH
NHPs	NHP's
N. I.	NI
N.I.	NI
N'I	NI
N. J.	NJ
N.J.	NJ
Njoo	NJOO
N.J.'s	NJ's
N. K.	NK
N.K.	NK
nkvd	NKVD
nkv	NKV
N. L.	NL
N.L.	NL
NLRs	NLR's
N. M.	NM
N.M.	NM
N. N.	NN
N.N.	NN
NPCs	NPC's
NPMs	NPM's
N. P.	NP
N.P.	NP
NPs	NP's
N. Q.	NQ
nri	NRI
Nri	NRI
NRIs	NRI's
NRJs	NRJ's
nr	NR
N. R.	NR
N.R.	NR
N. S.	NS
N.S.	NS
NSOs	NSO's
Nta	NTA
ntb	NTB
N. T.	NT
N.T.	NT
ntw	NTW
N.U.	NU
NvDA's	NVDA's
N. V.	NV
N.V.	NV
nwa	NWA
N&W	N and W
N. W.	NW
N.W.	NW
nyc	NYC
N. Y.	NY
N.Y.	NY
N'Zif	NZIF
NZiK	NZIK
N'Zi	NZI
N.Z.	NZ
O. A.	OA
O.A.	OA
obl	OBL
Oblt	OBLT
O.B.	OB
O. C.	OC
O.C.	OC
Octl	OCTL
O. D.	OD
O.E.	OE
O.F.	OF
ofr	OFR
O&G	O and G
O. G.	OG
O.G.	OG
O. H.	OH
O.H.	OH
O. I.	OI
O.I.	OI
O. J.	OJ
O.J.	OJ
OK'd	OKD
OKd	OKD
oke	OKE
Oke	OKE
O&K	O and K
O. K.	OK
O.K.	OK
O. L.	OL
O.L.	OL
Olo	OLO
Olov	OLOV
ols	OLS
OLs	OL's
olvwm	OLVWM
olwm	OLWM
O&MFL	O and MFL
omg	OMG
OMGs	OMG's
O. M.	OM
O.M.	OM
OmOm	OMOM
Om's	OM's
oncu	ONCU
ond	OND
onf	ONF
O. N.	ON
O.N.	ON
O&O	O and O
O. O.	OO
O.O.	OO
Oop	OOP
oor	OOR
oose	OOSE
Oo's	OO's
Ootw	OOTW
OPMs	OPM's
O. P.	OP
O.P.	OP
opr	OPR
Opr	OPR
ORFs	ORF's
OR&N	OR and N
O. R.	OR
osaa	OSAA
osa	OSA
Osa	OSA
OSBs	OSB's
O. S.	OS
O.S.	OS
OSTs	OST's
osv	OSV
O.T.	OT
OTs	OT's
Otu	OTU
otv	OTV
O.U.	OU
ovca	OVCA
Ovca	OVCA
Ovda	OVDA
Ovo	OVO
ov	OV
Ov	OV
O. V.	OV
O.V.	OV
OWCs	OWC's
O. W.	OW
O.W.	OW
pa	PA
P. A.	PA
P.A.	PA
pBCE	PBCE
pbc	PBC
pb	PB
P. B.	PB
P.B.	PB
PCBs	PCB's
PCDDs	PCDD's
PCeU	PCEU
PCIe	PCIE
pci	PCI
pcl	PCL
PcoA	PCOA
pc	PC
P. C.	PC
P.C.	PC
PCRev	PCREV
pcs	PCS
P.C.s	PC's
pDAB	PDAB
PDAs	PDA's
pdbp	PDBP
PDBsum	PDBSUM
PDCs	PDC's
PD&D	PD and D
PDEs	PDE's
pdf	PDF
PDFs	PDF's
P&D	P and D
P. D.	PD
P.D.	PD
PDPs	PDP's
PDs	PD's
P.E.I.'s	PEI's
P. E.	PE
P.E.	PE
PFs	PF's
PFW&C	PFW and C
PGMs	PGM's
PG&N	PG and N
P&G	P and G
P. G.	PG
P.G.	PG
Phlo	PHLO
P&H	P and H
P. H.	PH
P.H.	PH
php	PHP
PHPs	PHP's
P&I	P and I
P. I.	PI
P.I.	PI
Piz	PIZ
pj	PJ
P. J.	PJ
P.J.	PJ
PJs	PJ's
P. K.	PK
P.K.	PK
plc	PLC
PLCs	PLC's
P. L.	PL
P.L.	PL
PMMoV	PMMOV
p.m.	PM
p.m	PM
P. M.	PM
P.M.	PM
PMs	PM's
PNaCl	PNACL
pna	PNA
Pnau	PNAU
pnb	PNB
PNEs	PNE's
PNETs	PNET's
pneus	PNEUS
png	PNG
PNNs	PNN's
PNoy	PNOY
pn	PN
P. N.	PN
P.N.	PN
P.O.D.'s	POD's
P&O	P and O
P. O.	PO
P.O.	PO
P.O.W.'s	POW's
P&PH	P and PH
PPi	PPI
P. P.	PP
P.P.	PP
PPVs	PPV's
PPy	PPY
pr	PR
P. R.	PR
P.R.	PR
P. s	P's
P.'s	P's
Ps	P's
P. S.	PS
P.S.	PS
PSSAs	PSSA's
pTA	PTA
PTAs	PTA's
Pte	PTE
PTEs	PTE's
ptf	PTF
Ptie	PTIE
PTLs	PTL's
Ptol	PTOL
pt	PT
P. T.	PT
P.T.	PT
PTTs	PTT's
P'Twa	PTWA
Puiu	PUIU
Pul	PUL
PVAs	PVA's
PvdA	PVDA
pve	PVE
P. V.	PV
P.V.	PV
pvr	PVR
PVs	PV's
pwll	PWLL
P&W	P and W
P. W.	PW
P.W.	PW
Pyi	PYI
Pyk	PYK
Pyl	PYL
PyL	PYL
P. Y.	PY
Pyu	PYU
Pyw	PYW
Pyx	PYX
P. Z.	PZ
Q. A.	QA
Q&A	Q and A
Q&A's	Q and A's
Q&As	Q and A's
QbA	QBA
Q.B.	QB
Q.C.	QC
Q. E.	QE
Q.H.	QH
Q.I.	QI
Q. J.	QJ
Q. N.	QN
QPOs	QPO's
Q.V.	QV
R. A.	RA
R.A.	RA
R&A	R and A
R&AW	R and AW
RbAg	RBAG
RBCs	RBC's
RBIs	RBI's
R&B	R and B
R. B.	RB
R.B.	RB
rca	RCA
R&C	R and C
rc	RC
R. C.	RC
R.C.	RC
RCTs	RCT's
RdE	RDE
R&D	R and D
R. D.	RD
R.D.	RD
R.E.M.'s	REM's
REPLs	REPL's
R. E.	RE
R.E.	RE
R. F.	RF
R.F.	RF
R&G	R and G
R. G.	RG
R.G.	RG
RHIBs	RHIB's
Rhiw	RHIW
rhl	RHL
RhoG	RHOG
Rho's	RHO's
R. H.	RH
R.H.	RH
R&I	R and I
R. I.	RI
R.I.	RI
riu	RIU
Riu	RIU
rivs	RIVS
Rivu	RIVU
Rixt	RIXT
rjf	RJF
R. J.	RJ
R.J.	RJ
R. K.	RK
R.K.	RK
R. L.	RL
R.L.	RL
rly	RLY
RMDs	RMD's
RMLs	RML's
rm	RM
R. M.	RM
R.M.	RM
RMSDs	RMSD's
RMs	RM's
rna	RNA
RNAs	RNA's
Rnet	RNET
Rnic	RNIC
RNNs	RNN's
RNPs	RNP's
R. N.	RN
R.N.	RN
rOmpB	ROMPB
Rooi	ROOI
R. O.	RO
R.O.	RO
ROVs	ROV's
Roxb	ROXB
Roxx	ROXX
RP&C	RP and C
rpc	RPC
Rpe	RPE
rpg	RPG
RPGs	RPG's
rpm	RPM
R. P.	RP
R.P.	RP
RPs	RP's
R. Q.	RQ
R.Q.	RQ
rra	RRA
rrd	RRD
Rreli	RRELI
rre	RRE
rRNA	RRNA
rRNAs	RRNA's
R&R	R and R
rr	RR
R. R.	RR
R.R.	RR
rsh	RSH
Rsis	RSI's
rsly	RSLY
RsmA	RSMA
RSpec	RSPEC
rs	RS
Rs	R's
R. S.	RS
R.S.	RS
RSu	RSU
rtb	RTB
RTCs	RTC's
RTEjr	RTEJR
RTeOR	RTEOR
RTOs	RTO's
rtPA	RTPA
rt	RT
R. T.	RT
R.T.	RT
rts	RTS
RTVFBiH	RTVFBIH
Ruao	RUAO
Rukn	RUKN
Ruk	RUK
Rupf	RUPF
Rupr	RUPR
rup	RUP
Rup	RUP
R. U.	RU
R.U.	RU
RutB	RUTB
Ruu	RUU
Ruwa	RUWA
Ruy	RUY
Ruyt	RUYT
Rvat	RVAT
Rvo	RVO
R. V.	RV
R.V.	RV
rvs	RVS
rwa	RWA
Rwa	RWA
rwb	RWB
RWEs	RWE's
rwjf	RWJF
R. W.	RW
R.W.	RW
Rxa	RXA
rz	RZ
R. Z.	RZ
Sa'id	SAID
S. A.	SA
S.A.	SA
Saxl	SAXL
Sa'yo	SAYO
Sbai	SBAI
sbc	SBC
SBCs	SBC's
sbk	SBK
Sborz	SBORZ
sb	SB
S. B.	SB
S.B.	SB
Sbu	SBU
scr	SCR
SCRs	SCR's
scry	SCRY
sc	SC
S. C.	SC
S.C.	SC
Scuf	SCUF
Scymn	SCYMN
SD&AE	SD and AE
Sdei	SDEI
sde	SDE
Sde	SDE
SDG&E	SDG and E
sdk	SDK
S. D.	SD
S.D.	SD
SDSM&T's	SDSM and T's
Sejms	SEJM's
sejr	SEJR
Sekl	SEKL
Sek	SEK
S. E.	SE
S.E.	SE
ses	SES
Ses	SE's
SEs	SE's
S.E.S.'s	SES's
Seyh	SEYH
sfadb	SFADB
Sfax	SFAX
SFFCo	SFFCO
sfn	SFN
'sf	SF
sf	SF
S. F.	SF
S.F.	SF
sfs	SFS
S.F.'s	SF's
SG&A	SG and A
sgb	SGB
Sgip	SGIP
sgml	SGML
sgra	SGRA
S. G.	SG
S.G.	SG
SGSNs	SGSN's
Sgt.	sergeant
sgt	SGT
S.H.I.E.L.D.'s	SHIELD's
Shma	SHMA
S. H.	SH
S.H.	SH
S. I.	SI
S.I.	SI
sjef	SJEF
Sjon	SJON
S. J.	SJ
S.J.	SJ
S. K.	SK
S.K.	SK
S.L.A.A.'s	SLAA's
sla	SLA
SLAs	SLA's
S&L	S and L
SLS&E	SLS and E
S. L.	SL
S.L.	SL
SMe	SME
SMEs	SME's
SmI	SMI
SMPSs	SMPS's
smr	SMR
S&M	S and M
sm	SM
S. M.	SM
S.M.	SM
S.M.'s	SM's
SMs	SMS
Smyl	SMYL
SNESjr	SNESJR
sngle	SNGLE
SNPs	SNP's
SnSe	SNSE
S. N.	SN
S.N.	SN
S. O.	SO
S.O.	SO
Sos	SO's
Sovn	SOVN
Sov	SOV
S&P 500	S and P five  hundred
SPCAs	SPCA's
Spe	SPE
Spoa	SPOA
SpPIn	SPPIN
S&P	S and P
S. P.	SP
S.P.	SP
SPs	SP's
SPUs	SPU's
sql	SQL
sq	SQ
S. Q.	SQ
Sra	SRA
SRAs	SRA's
Srba	SRBA
Srbi	SRBI
SRBs	SRB's
SRGs	SRG's
Srhir	SRHIR
SRLGs	SRLG's
SRMs	SRM's
Srni	SRNI
srp	SRP
sr	SR
S. R.	SR
S.R.	SR
Srul	SRUL
srx	SRX
SSAs	SSA's
SSDs	SSD's
ssl	SSL
SSoSV	SSOSV
SSRIs	SSRI's
S&S	S and S
ss	SS
S. s	S's
Ss	S's
S. S.	SS
S.S.	SS
Ssu	SSU
ssw	SSW
Ssy	SSY
ST&AJ	ST and AJ
STDs	STD's
stfv	STFV
STGs	STG's
STIs	STI's
STi	STI
stl	STL
Stryj	STRYJ
S&T	S and T
STScI	STSCI
S. T.	ST
S.T.	ST
suo	SUO
Suo	SUO
S. U.	SU
Susz	SUSZ
SUTs	SUT's
Suu	SUU
SUVs	SUV's
Suy	SUY
Svac	SVAC
svar	SVAR
sve	SVE
Sve	SVE
SVMs	SVM's
svn	SVN
svom	SVOM
sv	SV
S. V.	SV
S.V.	SV
SVTs	SVT's
Swe	SWE
SwRI	SWRI
S&W	S and W
sw	SW
S. W.	SW
S.W.	SW
sx	SX
S.X.	SX
SysML	SYSML
SysRq	SYSRQ
Sys	SY's
SysV	SYSV
S. Y.	SY
S.Y.	SY
SyT	SYT
syv	SYV
Syxx	SYXX
Szasz	SZASZ
Szer	SZER
szkic	SZKIC
Szklo	SZKLO
Szlak	SZLAK
SzMME	SZMME
Szpir	SZPIR
sz	SZ
S. Z.	SZ
Szu	SZU
Szyk	SZYK
taf	TAF
Taf	TAF
T. A.	TA
T.A.	TA
T&A	T and A
TBCs	TBC's
TBMs	TBM's
tbh	TBH
T. B.	TB
T.B.	TB
TCiAP	TCIAP
TCKs	TCK's
tc	TC
T. C.	TC
T.C.	TC
TCUs	TCU's
tcu	TCU
tdb	TDB
TDCi	TDCI
TdIF	TDIF
TDs	TD's
T. D.	TD
T.D.	TD
Teatr	TEATR
T. E.	TE
T.E.	TE
T&F	T and F
tf	TF
T. F.	TF
T.F.	TF
tge	TGE
tgf	TGF
tg	TG
T. G.	TG
T.G.	TG
TGVs	TGV's
tgv	TGV
Thok	THOK
ThSe	THSE
T. H.	TH
T.H.	TH
T.I.'s	TI's
T.I.	TI
Tiu	TIU
tiv	TIV
Tiv	TIV
Tiy's	TIY's
T. J.	TJ
T.J.	TJ
t'ju	TJU
tjz	TJZ
tko	TKO
Tko	TKO
tk	TK
T. K.	TK
T.K.	TK
Tlas	TLA's
TlCu	TLCU
TLDs	TLD's
tli	TLI
tlp	TLP
TLRs	TLR's
TLs	TL's
tl	TL
T. L.	TL
T.L.	TL
Tluk	TLUK
Tluszcz	TLUSZCZ
tmc	TMC
TMGs	TMG's
tmos	TMOS
tmRNA	TMRNA
TMSs	TMS's
T.M.s	TM's
tm	TM
T. M.	TM
T.M.	TM
tna	TNA
tnbc	TNBC
TNTAs	TNTA's
tn	TN
T. N.	TN
T.N.	TN
T.O.'s	TO's
T. O.	TO
T.O.	TO
tou	TOU
Tou	TOU
ToU	TOU
tPA	TPA
tpr	TPR
tp	TP
T. P.	TP
T.P.	TP
TPVs	TPV's
T.Q.	TQ
tra	TRA
Tra	TRA
Trbic	TRBIC
Trcek	TRCEK
TrkA	TRKA
Trmcic	TRMCIC
tRNA	TRNA
TRPs	TRP's
trs	TRS
tr	TR
T. R.	TR
T.R.	TR
truTV	TRUTV
TruTV	TRUTV
Trve	TRVE
Tsa	TSA
tsit	TSIT
Tsiv	TSIV
tso	TSO
Tso	TSO
tsr	TSR
Ts	T's
T. S.	TS
T.S.	TS
tsus	TSUS
Tsvi	TSVI
Tta	TTA
tteok	TTEOK
tte	TTE
ttp	TTP
T&T	T and T
T. T.	TT
T.T.	TT
T'uqu	TUQU
T.U.	TU
Tuzk	TUZK
tvaan	TVAAN
Tvam	TVAM
tva	TVA
TVETs	TVET's
TVii	TVII
TVIn	TVIN
TVi	TVI
tvo	TVO
Tvo	TVO
TVRi	TVRI
tvr	TVR
TVSpy	TVSPY
tvs	TVS
TVs	TV's
tVTA	TVTA
tv	TV
T. V.	TV
T.V.	TV
Twa	TWA
Twi	TWI
TWTs	TWT's
T. W.	TW
T.W.	TW
TxDOT	TXDOT
T.X.	TX
tya	TYA
Tyk	TYK
Tza'ar	TZAAR
Tze	TZE
Tzrif	TZRIF
Tzuh	TZUH
Tzvi	TZVI
Ua's	UA's
UAs	UA's
uat	UAT
U.A.	UA
UAVs	UAV's
Uba	UBA
UbcM	UBCM
Ube	UBE
ubi	UBI
Ubi	UBI
Ucar	UCAR
Uca	UCA
Ucmak	UCMAK
Ucn	UCN
uCs	UC's
Uc	UC
U.C.	UC
Ucuncu	UCUNCU
Uczta	UCZTA
Uda	UDA
Udit	UDIT
Udny	UDNY
UDTs	UDT's
ud	UD
Ud	UD
U. D.	UD
udu	UDU
Udu	UDU
Ueda's	UEDA's
Uéda	UE acute DA
U. E.	UE
UFOs	UFO's
Ufot	UFOT
ufo	UFO
Ufo	UFO
U. F.	UF
Uga	UGA
Uge	UGE
Ugni	UGNI
Ugra	UGRA
Ugrszke	UGRSZKE
Ug	UG
Uhha	UHHA
uhn	UHN
UHTCs	UHTC's
Uhud	UHUD
U.H.	UH
uhur	UHUR
Uiam	UIAM
Uibh	UIBH
Uible	UIBLE
Uig	UIG
uisae	UISAE
UiS	UIS
UiTM	UITM
uit	UIT
Uit	UIT
Uiy	UIY
Ujed	UJED
Ujsag	UJSAG
uj	UJ
U.J.	UJ
Uka	UKA
Ukhra	UKHRA
Ukic	UKIC
Uki	UKI
Ukoh	UKOH
Uko	UKO
ukr	UKR
Ukr	UKR
Ukui	UKUI
u'k	UK
uk	UK
Uk	UK
U.K.	UK
Ukwu	UKWU
Ulic	ULIC
Ull	ULL
Ulms	ULM's
UlSU	ULSU
Uluj	ULUJ
U.L.	UL
ulus	ULUS
Ulus	ULU's
Ulwa	ULWA
Ulwe	ULWE
Umbr	UMBR
umelcu	UMELCU
UMe	UME
Umla	UMLA
Umme	UMME
Umno	UMNO
Umri	UMRI
U. M.	UM
U.M.	UM
Unli	UNLI
Unlu	UNLU
unm	UNM
unnd	UNND
UNSh	UNSH
Unst	UNST
Uns	UN's
U.N.'s	UN's
Unt	UNT
U.N.	UN
Unz	UNZ
UOCl	UOCL
UofM	UOFM
Uoho	UOHO
UoMs	UOM's
uORF	UORF
UoW	UOW
UPBs	UPB's
Upd	UPD
Upf	UPF
Upir	UPIR
UPnP	UPNP
Uppu	UPPU
U.P.	UP
UPyD	UPYD
uq	UQ
Urbz	URBZ
URCs	URC's
Urdd	URDD
Urei	UREI
urf	URF
Urla	URLA
URLhttp	URLHTTP
URLs	URL's
Usal	USAL
usan	USAN
Usan	USAN
usao	USAO
usata	USATA
usa	USA
.USA	USA
USAya	USAYA
USBs	USB's
Uscie	USCIE
U.S.C.'s	USC's
USDoE	USDOE
usd	USD
USFbA	USFBA
USF&WS	USF and WS
UShs	USH's
Usia	USIA
usih	USIH
Uslu	USLU
Usmar	USMAR
Usna	USNA
Usnic	USNIC
Usoi	USOI
Usos	USO's
Uso	USO
USPs	USP's
U.S.'s	US's
Usti	USTI
Ustka	USTKA
Usui	USUI
usum	USUM
U. S.	US
U.S.	US
Usut	USUT
Usvit	USVIT
Uta's	UTA's
uta	UTA
Uta	UTA
Utca	UTCA
Utd's	UTD's
Utd	UTD
utea	UTEA
Utes	UTE's
Uth	UTH
uti	UTI
Uti	UTI
Utne	UTNE
Utnur	UTNUR
Uto	UTO
utrci	UTRCI
utsav	UTSAV
Utsav	UTSAV
Utsu	UTSU
U.T.	UT
Utu	UTU
Utva	UTVA
Uuh	UUH
Uul	UUL
Uulu	UULU
Uusi	UUSI
UUs	UU's
Uuto	UUTO
Uvac	UVAC
Uvea	UVEA
uvnitr	UVNITR
Uvo	UVO
U.V.	UV
Uwasa	UWASA
UWFi	UWFI
V. A.	VA
V.A.	VA
V&A	V and A
Vav	VAV
Vay	VAY
vb	VB
V. B.	VB
V.B.	VB
VCDs	VCD's
VCRs	VCR's
VCSELs	VCSEL's
VCs	VC's
VCTs	VCT's
vc	VC
V. C.	VC
V.C.	VC
vda	VDA
Vda	VDA
VDCs	VDC's
vdiq	VDIQ
vdm	VDM
V. D.	VD
V.D.	VD
vez	VEZ
Vez	VEZ
vfp	VFP
vfr	VFR
V. F.	VF
V.F.	VF
V'Ger	VGER
vgmdb	VGMDB
VGo	VGO
VGSCs	VGSC's
VGSoM	VGSOM
V. G.	VG
V.G.	VG
V. H.	VH
V.I.C.'s	VIC's
Vict	VICT
viita	VIITA
vijf	VIJF
vij	VIJ
Vij	VIJ
V.I.P.s	VIP's
VIPs	VIP's
V. I.	VI
V.I.	VI
VJs	VJ's
V. J.	VJ
V.J.	VJ
V. K.	VK
V.K.	VK
Vlah	VLAH
VLCCs	VLCC's
vlei	VLEI
Vlijt	VLIJT
V. L.	VL
V.L.	VL
VMAs	VMA's
vm	VM
V. M.	VM
V.M.	VM
vner	VNER
V. N.	VN
V.N.	VN
V.O.	VO
Vov	VOV
Voz	VOZ
vpis	VPIS
VPNs	VPN's
vpu	VPU
V. P.	VP
V.P.	VP
vq	VQ
vrak	VRAK
Vrba	VRBA
Vrbuv	VRBUV
Vrej	VREJ
vrem	VREM
Vrin	VRIN
vrj	VRJ
vrn	VRN
vroee	VROEE
vrou	VROU
vrouw	VROUW
Vrouw	VROUW
Vrsac	VRSAC
Vrtis	VRTI's
V&R	V and R
vr	VR
V. R.	VR
V.R.	VR
VSANs	VSAN's
VSATs	VSAT's
Vsekh	VSEKH
vse	VSE
vso	VSO
VSPs	VSP's
vs.	versus
_vs._	versus
vsyo	VSYO
VTE	VT eL
Vtic	VTIC
VTi	VTI
V&T's	V and T's
V&T	V and T
V.T.	VT
Vuur	VUUR
VVIPs	VVIP's
V. V.	VV
V.V.	VV
VWs	VW's
Vyg	VYG
vyr	VYR
vy	VY
vz	VZ
V. Z.	VZ
Waay	WAAY
Wa'il	WAIL
Wakf	WAKF
wa'l	WAL
waqf	WAQF
waqt	WAQT
Waqt	WAQT
Wasl	WASL
Watfa	WATFA
wau	WAU
Wau	WAU
W. A.	WA
W.A.	WA
waw	WAW
waza	WAZA
Waza	WAZA
WBs	WB's
W. B.	WB
W.B.	WB
W&CBR	W and CBR
wc	WC
W. C.	WC
W.C.	WC
W. D.	WD
W.D.	WD
W. E.	WE
W.E.	WE
WF&NW	WF and NW
W&F	W and F
W. F.	WF
W.F.	WF
wga	WGA
wgn	WGN
wg	WG
W. G.	WG
W.G.	WG
W&H	W and H
W. H.	WH
W.H.	WH
Whyld	WHYLD
Wica	WICA
wici	WICI
Wif	WIF
Wijk	WIJK
Wiwa	WIWA
W. I.	WI
wjaz	WJAZ
W&J's	W and J's
W&J	W and J
W. J.	WJ
W.J.	WJ
W. K.	WK
W.K.	WK
W&LE	W and LE
Wley	WLEY
wlrs	WLRS
W. L.	WL
W.L.	WL
wml	WML
W&M	W and M
W. M.	WM
W.M.	WM
W. N.	WN
W.N.	WN
wnzaa	WNZAA
W&OD	W and OD
Worh	WORH
W. O.	WO
W.O.	WO
wpt	WPT
wp	WP
W. P.	WP
W.P.	WP
Wrec	WREC
W. R.	WR
W.R.	WR
ws	WS
W. S.	WS
W.S.	WS
WTs	WT's
WTTs	WTT's
W. T.	WT
W.T.	WT
WUAs	WUA's
Wudl	WUDL
Wuhr	WUHR
Wuhu	WUHU
Wu's	WU's
wuv	WUV
W. U.	WU
Wuz	WUZ
WVa	WVA
W. V.	WV
W.V.	WV
Wwe	WWE
W. W.	WW
W.W.	WW
wx	WX
W.Y.	WY
wyzc	WYZC
W. Z.	WZ
xbg	XBG
Xbra	XBRA
xCo	XCO
X. C.	XC
xda	XDA
XDRs	XDR's
X. D.	XD
Xfce	XFCE
xf	XF
X.F.	XF
xh	XH
X. H.	XH
xk	XK
xmc	XMC
xml	XML
X.M.	XM
xO	XO
X.O.	XO
XPe	XPE
X.Q.	XQ
XSi	XSI
xsr	XSR
XTwas	XTWA's
xt	XT
X. W.	XW
xy	XY
xyz	XYZ
xyZ	XYZ
Y. A.	YA
Y.A.	YA
Y. B.	YB
Y.B.	YB
ycia	YCIA
ycie	YCIE
yc	YC
Y. C.	YC
Y.C.	YC
Ydby	YDBY
Yde	YDE
YdiB	YDIB
yd	YD
Y. D.	YD
Y.D.	YD
Y.E.	YE
YFCs	YFC's
yfle	YFLE
YF&R	YF and R
yg	YG
Y. G.	YG
Y.G.	YG
Y. H.	YH
Y. I.	YI
Y.I.	YI
yj	YJ
Y. J.	YJ
Ykt	YKT
Y. K.	YK
Y.K.	YK
Yle	YLE
yl	YL
Y. L.	YL
Ymke	YMKE
ym	YM
Y. M.	YM
yndi	YNDI
Yndi	YNDI
yne	YNE
Yngve	YNGVE
Ynis	YNI's
yn	YN
Yn	YN
Y. N.	YN
Y.N.	YN
Y.O.	YO
ypa	YPA
Y.P.	YP
Y. Q.	YQ
yra	YRA
Yra	YRA
Y&R	Y and R
YSK'da	YSKDA
YSK'ya	YSKYA
Ys	Y's
Y.S.	YS
yta	YTA
Ytre	YTRE
Y&T	Y and T
Y. T.	YT
Y.T.	YT
Y. V.	YV
Y. W.	YW
Y.Y.	YY
Z. A.	ZA
Z.A.	ZA
Zdar	ZDAR
zda	ZDA
zg	ZG
Z.G.	ZG
zh	ZH
Z. H.	ZH
Z.H.	ZH
zijn	ZIJN
zij	ZIJ
Zij	ZIJ
Z. I.	ZI
Z. J.	ZJ
Z.K.	ZK
Z.L.	ZL
Z.M.	ZM
ZnO	ZNO
Zpav	ZPAV
Z.P.	ZP
ZrI	ZRI
Zsuzsa	ZSUZSA
Z.W.	ZW
Z.X.	ZX
Z. Y.	ZY
Z.Y.	ZY
Z. Z.	ZZ
Z.Z.	ZZ
