ACCESSORISE	ACCESSORIZE
ACCESSORISED	ACCESSORIZED
ACCESSORISES	ACCESSORIZES
ACCESSORISING	ACCESSORIZING
ACCLIMATISATION	ACCLIMATIZATION
ACCLIMATISE	ACCLIMATIZE
ACCLIMATISED	ACCLIMATIZED
ACCLIMATISES	ACCLIMATIZES
ACCLIMATISING	ACCLIMATIZING
ACCOUTREMENTS	ACCOUTERMENTS
AEON	EON
AEONS	EONS
AEROGRAMME	AEROGRAM
AEROGRAMMES	AEROGRAMS
AEROPLANE	AIRPLANE
AEROPLANES	AIRPLANES
AESTHETE	ESTHETE
AESTHETES	ESTHETES
AESTHETIC	ESTHETIC
AESTHETICALLY	ESTHETICALLY
AESTHETICS	ESTHETICS
AETIOLOGY	ETIOLOGY
AGEING	AGING
AGGRANDISEMENT	AGGRANDIZEMENT
AGONISE	AGONIZE
AGONISED	AGONIZED
AGONISES	AGONIZES
AGONISING	AGONIZING
AGONISINGLY	AGONIZINGLY
ALMANACK	ALMANAC
ALMANACKS	ALMANACS
ALUMINIUM	ALUMINUM
AMORTISABLE	AMORTIZABLE
AMORTISATION	AMORTIZATION
AMORTISATIONS	AMORTIZATIONS
AMORTISE	AMORTIZE
AMORTISED	AMORTIZED
AMORTISES	AMORTIZES
AMORTISING	AMORTIZING
AMPHITHEATRE	AMPHITHEATER
AMPHITHEATRES	AMPHITHEATERS
ANAEMIA	ANEMIA
ANAEMIC	ANEMIC
ANAESTHESIA	ANESTHESIA
ANAESTHETIC	ANESTHETIC
ANAESTHETICS	ANESTHETICS
ANAESTHETISE	ANESTHETIZE
ANAESTHETISED	ANESTHETIZED
ANAESTHETISES	ANESTHETIZES
ANAESTHETISING	ANESTHETIZING
ANAESTHETIST	ANESTHETIST
ANAESTHETISTS	ANESTHETISTS
ANAESTHETIZE	ANESTHETIZE
ANAESTHETIZED	ANESTHETIZED
ANAESTHETIZES	ANESTHETIZES
ANAESTHETIZING	ANESTHETIZING
ANALOGUES	ANALOGS
ANALYSE	ANALYZE
ANALYSED	ANALYZED
ANALYSES	ANALYZES
ANALYSING	ANALYZING
ANGLICISE	ANGLICIZE
ANGLICISED	ANGLICIZED
ANGLICISES	ANGLICIZES
ANGLICISING	ANGLICIZING
ANNUALISED	ANNUALIZED
ANTAGONISE	ANTAGONIZE
ANTAGONISED	ANTAGONIZED
ANTAGONISES	ANTAGONIZES
ANTAGONISING	ANTAGONIZING
APOLOGISED	APOLOGIZED
APOLOGISES	APOLOGIZES
APOLOGISING	APOLOGIZING
APPAL	APPALL
APPALS	APPALLS
APPETISER	APPETIZER
APPETISERS	APPETIZERS
APPETISING	APPETIZING
APPETISINGLY	APPETIZINGLY
ARBOUR	ARBOR
ARBOURS	ARBORS
ARCHAEOLOGICAL	ARCHEOLOGICAL
ARCHAEOLOGICALLY	ARCHEOLOGICALLY
ARCHAEOLOGIST	ARCHEOLOGIST
ARCHAEOLOGISTS	ARCHEOLOGISTS
ARCHAEOLOGY	ARCHEOLOGY
ARDOUR	ARDOR
ARMOURED	ARMORED
ARMOURER	ARMORER
ARMOURERS	ARMORERS
ARMOURIES	ARMORIES
ARMOURY	ARMORY
ARTEFACT	ARTIFACT
ARTEFACTS	ARTIFACTS
AUTHORISE	AUTHORIZE
AUTHORISED	AUTHORIZED
AUTHORISES	AUTHORIZES
AUTHORISING	AUTHORIZING
AXE	AX
BACKPEDALLED	BACKPEDALED
BACKPEDALLING	BACKPEDALING
BANNISTERS	BANISTERS
BAPTISE	BAPTIZE
BAPTISED	BAPTIZED
BAPTISES	BAPTIZES
BAPTISING	BAPTIZING
BASTARDISE	BASTARDIZE
BASTARDISED	BASTARDIZED
BASTARDISES	BASTARDIZES
BASTARDISING	BASTARDIZING
BATTLEAXE	BATTLEAX
BAULK	BALK
BAULKED	BALKED
BAULKING	BALKING
BAULKS	BALKS
BEDEVILLED	BEDEVILED
BEDEVILLING	BEDEVILING
BEHAVIOUR	BEHAVIOR
BEHAVIOURAL	BEHAVIORAL
BEHAVIOURISM	BEHAVIORISM
BEHAVIOURIST	BEHAVIORIST
BEHAVIOURISTS	BEHAVIORISTS
BEHAVIOURS	BEHAVIORS
BEHOVE	BEHOOVE
BEHOVED	BEHOOVED
BEHOVES	BEHOOVES
BEJEWELLED	BEJEWELED
BELABOUR	BELABOR
BELABOURED	BELABORED
BELABOURING	BELABORING
BELABOURS	BELABORS
BEVELLED	BEVELED
BEVVIES	BEVIES
BEVVY	BEVY
BIASSED	BIASED
BIASSING	BIASING
BINGEING	BINGING
BOUGAINVILLAEA	BOUGAINVILLEA
BOUGAINVILLAEAS	BOUGAINVILLEAS
BOWDLERISE	BOWDLERIZE
BOWDLERISED	BOWDLERIZED
BOWDLERISES	BOWDLERIZES
BOWDLERISING	BOWDLERIZING
BREATHALYSED	BREATHALYZED
BREATHALYSER	BREATHALYZER
BREATHALYSERS	BREATHALYZERS
BREATHALYSES	BREATHALYZES
BREATHALYSING	BREATHALYZING
BRUTALISE	BRUTALIZE
BRUTALISED	BRUTALIZED
BRUTALISES	BRUTALIZES
BRUTALISING	BRUTALIZING
BUSES	BUSSES
BUSING	BUSSING
CAESAREAN	CESAREAN
CAESAREANS	CESAREANS
CALIBRE	CALIBER
CALIBRES	CALIBERS
CALLIPER	CALIPER
CALLIPERS	CALIPERS
CALLISTHENICS	CALISTHENICS
CANALISE	CANALIZE
CANALISED	CANALIZED
CANALISES	CANALIZES
CANALISING	CANALIZING
CANCELLATION	CANCELATION
CANCELLATIONS	CANCELATIONS
CANCELLING	CANCELING
CANDOUR	CANDOR
CANNIBALISE	CANNIBALIZE
CANNIBALISED	CANNIBALIZED
CANNIBALISES	CANNIBALIZES
CANNIBALISING	CANNIBALIZING
CANONISE	CANONIZE
CANONISED	CANONIZED
CANONISES	CANONIZES
CANONISING	CANONIZING
CAPITALISE	CAPITALIZE
CAPITALISED	CAPITALIZED
CAPITALISES	CAPITALIZES
CAPITALISING	CAPITALIZING
CARAMELISE	CARAMELIZE
CARAMELISED	CARAMELIZED
CARAMELISES	CARAMELIZES
CARAMELISING	CARAMELIZING
CARBONISE	CARBONIZE
CARBONISED	CARBONIZED
CARBONISES	CARBONIZES
CARBONISING	CARBONIZING
CAROLLED	CAROLED
CAROLLING	CAROLING
CATALOGUED	CATALOGED
CATALOGUES	CATALOGS
CATALOGUING	CATALOGING
CATALYSE	CATALYZE
CATALYSED	CATALYZED
CATALYSES	CATALYZES
CATALYSING	CATALYZING
CATEGORISED	CATEGORIZED
CATEGORISES	CATEGORIZES
CATEGORISING	CATEGORIZING
CAUTERISE	CAUTERIZE
CAUTERISED	CAUTERIZED
CAUTERISES	CAUTERIZES
CAUTERISING	CAUTERIZING
CAVILLED	CAVILED
CAVILLING	CAVILING
CENTIGRAMME	CENTIGRAM
CENTIGRAMMES	CENTIGRAMS
CENTILITRE	CENTILITER
CENTILITRES	CENTILITERS
CENTRALISE	CENTRALIZE
CENTRALISED	CENTRALIZED
CENTRALISES	CENTRALIZES
CENTRALISING	CENTRALIZING
CENTRED	CENTERED
CENTREFOLD	CENTERFOLD
CENTREFOLDS	CENTERFOLDS
CENTREPIECE	CENTERPIECE
CENTREPIECES	CENTERPIECES
CHANNELLED	CHANNELED
CHANNELLING	CHANNELING
CHARACTERISE	CHARACTERIZE
CHARACTERISED	CHARACTERIZED
CHARACTERISES	CHARACTERIZES
CHARACTERISING	CHARACTERIZING
CHEQUE	CHECK
CHEQUEBOOK	CHECKBOOK
CHEQUEBOOKS	CHECKBOOKS
CHEQUERED	CHECKERED
CHEQUES	CHECKS
CHILLI	CHILI
CHIMAERA	CHIMERA
CHIMAERAS	CHIMERAS
CHISELLED	CHISELED
CHISELLING	CHISELING
CIRCULARISE	CIRCULARIZE
CIRCULARISED	CIRCULARIZED
CIRCULARISES	CIRCULARIZES
CIRCULARISING	CIRCULARIZING
CIVILISE	CIVILIZE
CIVILISED	CIVILIZED
CIVILISES	CIVILIZES
CIVILISING	CIVILIZING
CLAMOUR	CLAMOR
CLAMOURED	CLAMORED
CLAMOURING	CLAMORING
CLAMOURS	CLAMORS
CLANGOUR	CLANGOR
CLARINETTIST	CLARINETIST
CLARINETTISTS	CLARINETISTS
COLLECTIVISE	COLLECTIVIZE
COLLECTIVISED	COLLECTIVIZED
COLLECTIVISES	COLLECTIVIZES
COLLECTIVISING	COLLECTIVIZING
COLONISATION	COLONIZATION
COLONISE	COLONIZE
COLONISED	COLONIZED
COLONISER	COLONIZER
COLONISERS	COLONIZERS
COLONISES	COLONIZES
COLONISING	COLONIZING
COLOURANT	COLORANT
COLOURANTS	COLORANTS
COLOUREDS	COLOREDS
COLOURFULLY	COLORFULLY
COLOURING	COLORING
COLOURIZE	COLORIZE
COLOURIZED	COLORIZED
COLOURIZES	COLORIZES
COLOURIZING	COLORIZING
COLOURLESS	COLORLESS
COLOURS	COLORS
COMMERCIALISE	COMMERCIALIZE
COMMERCIALISED	COMMERCIALIZED
COMMERCIALISES	COMMERCIALIZES
COMMERCIALISING	COMMERCIALIZING
COMPARTMENTALISE	COMPARTMENTALIZE
COMPARTMENTALISED	COMPARTMENTALIZED
COMPARTMENTALISES	COMPARTMENTALIZES
COMPARTMENTALISING	COMPARTMENTALIZING
COMPUTERISE	COMPUTERIZE
COMPUTERISED	COMPUTERIZED
COMPUTERISES	COMPUTERIZES
COMPUTERISING	COMPUTERIZING
CONCEPTUALISE	CONCEPTUALIZE
CONCEPTUALISED	CONCEPTUALIZED
CONCEPTUALISES	CONCEPTUALIZES
CONCEPTUALISING	CONCEPTUALIZING
CONNEXION	CONNECTION
CONNEXIONS	CONNECTIONS
CONTEXTUALISE	CONTEXTUALIZE
CONTEXTUALISED	CONTEXTUALIZED
CONTEXTUALISES	CONTEXTUALIZES
CONTEXTUALISING	CONTEXTUALIZING
COSIER	COZIER
COSIES	COZIES
COSIEST	COZIEST
COSILY	COZILY
COSINESS	COZINESS
COSY	COZY
COUNCILLOR	COUNCILOR
COUNCILLORS	COUNCILORS
COUNSELLING	COUNSELING
COUNSELLOR	COUNSELOR
COUNSELLORS	COUNSELORS
CRENELLATED	CRENELATED
CRIMINALISE	CRIMINALIZE
CRIMINALISED	CRIMINALIZED
CRIMINALISES	CRIMINALIZES
CRIMINALISING	CRIMINALIZING
CRITICISE	CRITICIZE
CRITICISED	CRITICIZED
CRITICISES	CRITICIZES
CRITICISING	CRITICIZING
CRUELLER	CRUELER
CRUELLEST	CRUELEST
CRYSTALLISATION	CRYSTALLIZATION
CRYSTALLISE	CRYSTALLIZE
CRYSTALLISED	CRYSTALLIZED
CRYSTALLISES	CRYSTALLIZES
CRYSTALLISING	CRYSTALLIZING
CUDGELLED	CUDGELED
CUDGELLING	CUDGELING
CUSTOMISE	CUSTOMIZE
CUSTOMISED	CUSTOMIZED
CUSTOMISES	CUSTOMIZES
CUSTOMISING	CUSTOMIZING
CYPHER	CIPHER
CYPHERS	CIPHERS
DECENTRALISATION	DECENTRALIZATION
DECENTRALISE	DECENTRALIZE
DECENTRALISED	DECENTRALIZED
DECENTRALISES	DECENTRALIZES
DECENTRALISING	DECENTRALIZING
DECRIMINALISATION	DECRIMINALIZATION
DECRIMINALISE	DECRIMINALIZE
DECRIMINALISED	DECRIMINALIZED
DECRIMINALISES	DECRIMINALIZES
DECRIMINALISING	DECRIMINALIZING
DEFENCELESS	DEFENSELESS
DEFENCES	DEFENSES
DEHUMANISATION	DEHUMANIZATION
DEHUMANISE	DEHUMANIZE
DEHUMANISED	DEHUMANIZED
DEHUMANISES	DEHUMANIZES
DEHUMANISING	DEHUMANIZING
DEMEANOUR	DEMEANOR
DEMILITARISATION	DEMILITARIZATION
DEMILITARISE	DEMILITARIZE
DEMILITARISED	DEMILITARIZED
DEMILITARISES	DEMILITARIZES
DEMILITARISING	DEMILITARIZING
DEMOBILISATION	DEMOBILIZATION
DEMOBILISE	DEMOBILIZE
DEMOBILISED	DEMOBILIZED
DEMOBILISES	DEMOBILIZES
DEMOBILISING	DEMOBILIZING
DEMOCRATISATION	DEMOCRATIZATION
DEMOCRATISE	DEMOCRATIZE
DEMOCRATISED	DEMOCRATIZED
DEMOCRATISES	DEMOCRATIZES
DEMOCRATISING	DEMOCRATIZING
DEMONISE	DEMONIZE
DEMONISED	DEMONIZED
DEMONISES	DEMONIZES
DEMONISING	DEMONIZING
DEMORALISATION	DEMORALIZATION
DEMORALISE	DEMORALIZE
DEMORALISED	DEMORALIZED
DEMORALISES	DEMORALIZES
DEMORALISING	DEMORALIZING
DENATIONALISATION	DENATIONALIZATION
DENATIONALISE	DENATIONALIZE
DENATIONALISED	DENATIONALIZED
DENATIONALISES	DENATIONALIZES
DENATIONALISING	DENATIONALIZING
DEODORISE	DEODORIZE
DEODORISED	DEODORIZED
DEODORISES	DEODORIZES
DEODORISING	DEODORIZING
DEPERSONALISE	DEPERSONALIZE
DEPERSONALISED	DEPERSONALIZED
DEPERSONALISES	DEPERSONALIZES
DEPERSONALISING	DEPERSONALIZING
DEPUTISE	DEPUTIZE
DEPUTISED	DEPUTIZED
DEPUTISES	DEPUTIZES
DEPUTISING	DEPUTIZING
DESENSITISATION	DESENSITIZATION
DESENSITISE	DESENSITIZE
DESENSITISED	DESENSITIZED
DESENSITISES	DESENSITIZES
DESENSITISING	DESENSITIZING
DESTABILISATION	DESTABILIZATION
DESTABILISE	DESTABILIZE
DESTABILISED	DESTABILIZED
DESTABILISES	DESTABILIZES
DESTABILISING	DESTABILIZING
DIALLED	DIALED
DIALLING	DIALING
DIALOGUES	DIALOGS
DIARRHOEA	DIARRHEA
DIGITISE	DIGITIZE
DIGITISED	DIGITIZED
DIGITISES	DIGITIZES
DIGITISING	DIGITIZING
DISC	DISK
DISCOLOURED	DISCOLORED
DISCOLOURING	DISCOLORING
DISCOLOURS	DISCOLORS
DISCS	DISKS
DISEMBOWELLED	DISEMBOWELED
DISEMBOWELLING	DISEMBOWELING
DISFAVOUR	DISFAVOR
DISHEVELLED	DISHEVELED
DISHONOUR	DISHONOR
DISHONOURABLE	DISHONORABLE
DISHONOURABLY	DISHONORABLY
DISHONOURED	DISHONORED
DISHONOURING	DISHONORING
DISHONOURS	DISHONORS
DISORGANISATION	DISORGANIZATION
DISORGANISED	DISORGANIZED
DISTIL	DISTILL
DISTILS	DISTILLS
DRAMATISATION	DRAMATIZATION
DRAMATISATIONS	DRAMATIZATIONS
DRAMATISE	DRAMATIZE
DRAMATISED	DRAMATIZED
DRAMATISES	DRAMATIZES
DRAMATISING	DRAMATIZING
DRAUGHT	DRAFT
DRAUGHTBOARD	DRAFTBOARD
DRAUGHTBOARDS	DRAFTBOARDS
DRAUGHTIER	DRAFTIER
DRAUGHTIEST	DRAFTIEST
DRAUGHTS	DRAFTS
DRAUGHTSMAN	DRAFTSMAN
DRAUGHTSMANSHIP	DRAFTSMANSHIP
DRAUGHTSMEN	DRAFTSMEN
DRAUGHTSWOMAN	DRAFTSWOMAN
DRAUGHTSWOMEN	DRAFTSWOMEN
DRAUGHTY	DRAFTY
DRIVELLED	DRIVELED
DRIVELLING	DRIVELING
DUELLED	DUELED
DUELLING	DUELING
ECONOMISE	ECONOMIZE
ECONOMISED	ECONOMIZED
ECONOMISES	ECONOMIZES
ECONOMISING	ECONOMIZING
EDOEMA	EDEMA
EDITORIALISE	EDITORIALIZE
EDITORIALISED	EDITORIALIZED
EDITORIALISES	EDITORIALIZES
EDITORIALISING	EDITORIALIZING
EMPATHISE	EMPATHIZE
EMPATHISED	EMPATHIZED
EMPATHISES	EMPATHIZES
EMPATHISING	EMPATHIZING
EMPHASISE	EMPHASIZE
EMPHASISED	EMPHASIZED
EMPHASISES	EMPHASIZES
EMPHASISING	EMPHASIZING
ENAMELLED	ENAMELED
ENAMELLING	ENAMELING
ENAMOURED	ENAMORED
ENCYCLOPAEDIA	ENCYCLOPEDIA
ENCYCLOPAEDIAS	ENCYCLOPEDIAS
ENCYCLOPAEDIC	ENCYCLOPEDIC
ENDEAVOUR	ENDEAVOR
ENDEAVOURED	ENDEAVORED
ENDEAVOURING	ENDEAVORING
ENDEAVOURS	ENDEAVORS
ENERGISE	ENERGIZE
ENERGISED	ENERGIZED
ENERGISES	ENERGIZES
ENERGISING	ENERGIZING
ENROL	ENROLL
ENROLS	ENROLLS
ENTHRAL	ENTHRALL
ENTHRALS	ENTHRALLS
EPAULETTE	EPAULET
EPAULETTES	EPAULETS
EPICENTRE	EPICENTER
EPICENTRES	EPICENTERS
EPILOGUE	EPILOG
EPILOGUES	EPILOGS
EPITOMISE	EPITOMIZE
EPITOMISED	EPITOMIZED
EPITOMISES	EPITOMIZES
EPITOMISING	EPITOMIZING
EQUALISATION	EQUALIZATION
EQUALISE	EQUALIZE
EQUALISED	EQUALIZED
EQUALISER	EQUALIZER
EQUALISERS	EQUALIZERS
EQUALISES	EQUALIZES
EQUALISING	EQUALIZING
EULOGISE	EULOGIZE
EULOGISED	EULOGIZED
EULOGISES	EULOGIZES
EULOGISING	EULOGIZING
EVANGELISE	EVANGELIZE
EVANGELISED	EVANGELIZED
EVANGELISES	EVANGELIZES
EVANGELISING	EVANGELIZING
EXORCISE	EXORCIZE
EXORCISED	EXORCIZED
EXORCISES	EXORCIZES
EXORCISING	EXORCIZING
EXTEMPORISATION	EXTEMPORIZATION
EXTEMPORISE	EXTEMPORIZE
EXTEMPORISED	EXTEMPORIZED
EXTEMPORISES	EXTEMPORIZES
EXTEMPORISING	EXTEMPORIZING
EXTERNALISATION	EXTERNALIZATION
EXTERNALISATIONS	EXTERNALIZATIONS
EXTERNALISE	EXTERNALIZE
EXTERNALISED	EXTERNALIZED
EXTERNALISES	EXTERNALIZES
EXTERNALISING	EXTERNALIZING
FACTORISE	FACTORIZE
FACTORISED	FACTORIZED
FACTORISES	FACTORIZES
FACTORISING	FACTORIZING
FAECAL	FECAL
FAECES	FECES
FAMILIARISATION	FAMILIARIZATION
FAMILIARISE	FAMILIARIZE
FAMILIARISED	FAMILIARIZED
FAMILIARISES	FAMILIARIZES
FAMILIARISING	FAMILIARIZING
FANTASISE	FANTASIZE
FANTASISED	FANTASIZED
FANTASISES	FANTASIZES
FANTASISING	FANTASIZING
FAVOURABLE	FAVORABLE
FAVOURABLY	FAVORABLY
FAVOURED	FAVORED
FAVOURING	FAVORING
FAVOURITE	FAVORITE
FAVOURITES	FAVORITES
FAVOURITISM	FAVORITISM
FAVOURS	FAVORS
FEMINISE	FEMINIZE
FEMINISED	FEMINIZED
FEMINISES	FEMINIZES
FEMINISING	FEMINIZING
FERTILISATION	FERTILIZATION
FERTILISE	FERTILIZE
FERTILISED	FERTILIZED
FERTILISER	FERTILIZER
FERTILISERS	FERTILIZERS
FERTILISES	FERTILIZES
FERTILISING	FERTILIZING
FERVOUR	FERVOR
FIBREGLASS	FIBERGLASS
FIBRES	FIBERS
FICTIONALISATION	FICTIONALIZATION
FICTIONALISATIONS	FICTIONALIZATIONS
FICTIONALISE	FICTIONALIZE
FICTIONALISED	FICTIONALIZED
FICTIONALISES	FICTIONALIZES
FICTIONALISING	FICTIONALIZING
FILLET	FILET
FILLETED	FILETED
FILLETING	FILETING
FILLETS	FILETS
FINALISATION	FINALIZATION
FINALISE	FINALIZE
FINALISED	FINALIZED
FINALISES	FINALIZES
FINALISING	FINALIZING
FLAUTIST	FLUTIST
FLAUTISTS	FLUTISTS
FLAVOURED	FLAVORED
FLAVOURING	FLAVORING
FLAVOURINGS	FLAVORINGS
FLAVOURLESS	FLAVORLESS
FLAVOURS	FLAVORS
FLAVOURSOME	FLAVORSOME
FLYER/FLIER	FLIER/FLYER
FOETAL	FETAL
FOETID	FETID
FOETUS	FETUS
FOETUSES	FETUSES
FORMALISATION	FORMALIZATION
FORMALISE	FORMALIZE
FORMALISED	FORMALIZED
FORMALISES	FORMALIZES
FORMALISING	FORMALIZING
FOSSILISATION	FOSSILIZATION
FOSSILISE	FOSSILIZE
FOSSILISED	FOSSILIZED
FOSSILISES	FOSSILIZES
FOSSILISING	FOSSILIZING
FRATERNISATION	FRATERNIZATION
FRATERNISE	FRATERNIZE
FRATERNISED	FRATERNIZED
FRATERNISES	FRATERNIZES
FRATERNISING	FRATERNIZING
FULFIL	FULFILL
FULFILMENT	FULFILLMENT
FULFILS	FULFILLS
FUNNELLED	FUNNELED
FUNNELLING	FUNNELING
GALVANISE	GALVANIZE
GALVANISED	GALVANIZED
GALVANISES	GALVANIZES
GALVANISING	GALVANIZING
GAMBOLLED	GAMBOLED
GAMBOLLING	GAMBOLING
GAOL	JAIL
GAOLBIRD	JAILBIRD
GAOLBIRDS	JAILBIRDS
GAOLBREAK	JAILBREAK
GAOLBREAKS	JAILBREAKS
GAOLED	JAILED
GAOLER	JAILER
GAOLERS	JAILERS
GAOLING	JAILING
GAOLS	JAILS
GASES	GASSES
GAUGE	GAGE
GAUGED	GAGED
GAUGES	GAGES
GAUGING	GAGING
GENERALISATION	GENERALIZATION
GENERALISATIONS	GENERALIZATIONS
GENERALISE	GENERALIZE
GENERALISED	GENERALIZED
GENERALISES	GENERALIZES
GENERALISING	GENERALIZING
GHETTOISE	GHETTOIZE
GHETTOISED	GHETTOIZED
GHETTOISES	GHETTOIZES
GHETTOISING	GHETTOIZING
GIPSIES	GYPSIES
GLAMORISE	GLAMORIZE
GLAMORISED	GLAMORIZED
GLAMORISES	GLAMORIZES
GLAMORISING	GLAMORIZING
GLAMOUR	GLAMOR
GLOBALISATION	GLOBALIZATION
GLOBALISE	GLOBALIZE
GLOBALISED	GLOBALIZED
GLOBALISES	GLOBALIZES
GLOBALISING	GLOBALIZING
GLUEING	GLUING
GOITRE	GOITER
GOITRES	GOITERS
GONORRHOEA	GONORRHEA
GRAMME	GRAM
GRAMMES	GRAMS
GRAVELLED	GRAVELED
GREY	GRAY
GREYED	GRAYED
GREYING	GRAYING
GREYISH	GRAYISH
GREYNESS	GRAYNESS
GREYS	GRAYS
GROVELLED	GROVELED
GROVELLING	GROVELING
GROYNE	GROIN
GROYNES	GROINS
GRUELLING	GRUELING
GRUELLINGLY	GRUELINGLY
GRYPHON	GRIFFIN
GRYPHONS	GRIFFINS
GYNAECOLOGICAL	GYNECOLOGICAL
GYNAECOLOGIST	GYNECOLOGIST
GYNAECOLOGISTS	GYNECOLOGISTS
GYNAECOLOGY	GYNECOLOGY
HAEMATOLOGICAL	HEMATOLOGICAL
HAEMATOLOGIST	HEMATOLOGIST
HAEMATOLOGISTS	HEMATOLOGISTS
HAEMATOLOGY	HEMATOLOGY
HAEMOGLOBIN	HEMOGLOBIN
HAEMOPHILIA	HEMOPHILIA
HAEMOPHILIAC	HEMOPHILIAC
HAEMOPHILIACS	HEMOPHILIACS
HAEMORRHAGE	HEMORRHAGE
HAEMORRHAGED	HEMORRHAGED
HAEMORRHAGES	HEMORRHAGES
HAEMORRHAGING	HEMORRHAGING
HAEMORRHOIDS	HEMORRHOIDS
HARBOUR	HARBOR
HARBOURED	HARBORED
HARBOURING	HARBORING
HARBOURS	HARBORS
HARMONISATION	HARMONIZATION
HARMONISE	HARMONIZE
HARMONISED	HARMONIZED
HARMONISES	HARMONIZES
HARMONISING	HARMONIZING
HOMOEOPATH	HOMEOPATH
HOMOEOPATHIC	HOMEOPATHIC
HOMOEOPATHS	HOMEOPATHS
HOMOEOPATHY	HOMEOPATHY
HOMOGENISE	HOMOGENIZE
HOMOGENISED	HOMOGENIZED
HOMOGENISES	HOMOGENIZES
HOMOGENISING	HOMOGENIZING
HONOURABLY	HONORABLY
HONOURED	HONORED
HONOURING	HONORING
HONOURS	HONORS
HOSPITALISATION	HOSPITALIZATION
HOSPITALISE	HOSPITALIZE
HOSPITALISED	HOSPITALIZED
HOSPITALISES	HOSPITALIZES
HOSPITALISING	HOSPITALIZING
HUMANISE	HUMANIZE
HUMANISED	HUMANIZED
HUMANISES	HUMANIZES
HUMANISING	HUMANIZING
HUMOURED	HUMORED
HUMOURING	HUMORING
HUMOURLESS	HUMORLESS
HUMOURS	HUMORS
HYBRIDISE	HYBRIDIZE
HYBRIDISED	HYBRIDIZED
HYBRIDISES	HYBRIDIZES
HYBRIDISING	HYBRIDIZING
HYPNOTISE	HYPNOTIZE
HYPNOTISED	HYPNOTIZED
HYPNOTISES	HYPNOTIZES
HYPNOTISING	HYPNOTIZING
HYPOTHESISE	HYPOTHESIZE
HYPOTHESISED	HYPOTHESIZED
HYPOTHESISES	HYPOTHESIZES
HYPOTHESISING	HYPOTHESIZING
IDEALISATION	IDEALIZATION
IDEALISE	IDEALIZE
IDEALISED	IDEALIZED
IDEALISES	IDEALIZES
IDEALISING	IDEALIZING
IDOLISE	IDOLIZE
IDOLISED	IDOLIZED
IDOLISES	IDOLIZES
IDOLISING	IDOLIZING
IMMOBILISATION	IMMOBILIZATION
IMMOBILISE	IMMOBILIZE
IMMOBILISED	IMMOBILIZED
IMMOBILISER	IMMOBILIZER
IMMOBILISERS	IMMOBILIZERS
IMMOBILISES	IMMOBILIZES
IMMOBILISING	IMMOBILIZING
IMMORTALISE	IMMORTALIZE
IMMORTALISED	IMMORTALIZED
IMMORTALISES	IMMORTALIZES
IMMORTALISING	IMMORTALIZING
IMMUNISATION	IMMUNIZATION
IMMUNISE	IMMUNIZE
IMMUNISED	IMMUNIZED
IMMUNISES	IMMUNIZES
IMMUNISING	IMMUNIZING
IMPANELLED	IMPANELED
IMPANELLING	IMPANELING
IMPERILLED	IMPERILED
IMPERILLING	IMPERILING
INDIVIDUALISE	INDIVIDUALIZE
INDIVIDUALISED	INDIVIDUALIZED
INDIVIDUALISES	INDIVIDUALIZES
INDIVIDUALISING	INDIVIDUALIZING
INDUSTRIALISE	INDUSTRIALIZE
INDUSTRIALISED	INDUSTRIALIZED
INDUSTRIALISES	INDUSTRIALIZES
INDUSTRIALISING	INDUSTRIALIZING
INFLEXION	INFLECTION
INFLEXIONS	INFLECTIONS
INITIALISE	INITIALIZE
INITIALISED	INITIALIZED
INITIALISES	INITIALIZES
INITIALISING	INITIALIZING
INITIALLED	INITIALED
INITIALLING	INITIALING
INSTAL	INSTALL
INSTALMENT	INSTALLMENT
INSTALMENTS	INSTALLMENTS
INSTALS	INSTALLS
INSTIL	INSTILL
INSTILS	INSTILLS
INSTITUTIONALISATION	INSTITUTIONALIZATION
INSTITUTIONALISE	INSTITUTIONALIZE
INSTITUTIONALISED	INSTITUTIONALIZED
INSTITUTIONALISES	INSTITUTIONALIZES
INSTITUTIONALISING	INSTITUTIONALIZING
INTELLECTUALISE	INTELLECTUALIZE
INTELLECTUALISED	INTELLECTUALIZED
INTELLECTUALISES	INTELLECTUALIZES
INTELLECTUALISING	INTELLECTUALIZING
INTERNALISATION	INTERNALIZATION
INTERNALISE	INTERNALIZE
INTERNALISED	INTERNALIZED
INTERNALISES	INTERNALIZES
INTERNALISING	INTERNALIZING
INTERNATIONALISATION	INTERNATIONALIZATION
INTERNATIONALISE	INTERNATIONALIZE
INTERNATIONALISED	INTERNATIONALIZED
INTERNATIONALISES	INTERNATIONALIZES
INTERNATIONALISING	INTERNATIONALIZING
IONISATION	IONIZATION
IONISE	IONIZE
IONISED	IONIZED
IONISER	IONIZER
IONISERS	IONIZERS
IONISES	IONIZES
IONISING	IONIZING
ITALICISE	ITALICIZE
ITALICISED	ITALICIZED
ITALICISES	ITALICIZES
ITALICISING	ITALICIZING
ITEMISE	ITEMIZE
ITEMISED	ITEMIZED
ITEMISES	ITEMIZES
ITEMISING	ITEMIZING
JEOPARDISE	JEOPARDIZE
JEOPARDISED	JEOPARDIZED
JEOPARDISES	JEOPARDIZES
JEOPARDISING	JEOPARDIZING
JEWELLED	JEWELED
JEWELLER	JEWELER
JEWELLERS	JEWELERS
JEWELLERY	JEWELRY
KILOGRAMME	KILOGRAM
KILOGRAMMES	KILOGRAMS
LABELLED	LABELED
LABELLING	LABELING
LABOURED	LABORED
LABOURER	LABORER
LABOURERS	LABORERS
LABOURING	LABORING
LABOURS	LABORS
LACKLUSTRE	LACKLUSTER
LEGALISATION	LEGALIZATION
LEGALISE	LEGALIZE
LEGALISED	LEGALIZED
LEGALISES	LEGALIZES
LEGALISING	LEGALIZING
LEGITIMISE	LEGITIMIZE
LEGITIMISED	LEGITIMIZED
LEGITIMISES	LEGITIMIZES
LEGITIMISING	LEGITIMIZING
LEVELLED	LEVELED
LEVELLER	LEVELER
LEVELLERS	LEVELERS
LIBELLED	LIBELED
LIBELLING	LIBELING
LIBELLOUS	LIBELOUS
LIBERALISATION	LIBERALIZATION
LIBERALISE	LIBERALIZE
LIBERALISED	LIBERALIZED
LIBERALISES	LIBERALIZES
LIBERALISING	LIBERALIZING
LICENCED	LICENSED
LICENCES	LICENSES
LICENCING	LICENSING
LIKEABLE	LIKABLE
LIONISATION	LIONIZATION
LIONISE	LIONIZE
LIONISED	LIONIZED
LIONISES	LIONIZES
LIONISING	LIONIZING
LIQUIDISE	LIQUIDIZE
LIQUIDISED	LIQUIDIZED
LIQUIDISER	LIQUIDIZER
LIQUIDISERS	LIQUIDIZERS
LIQUIDISES	LIQUIDIZES
LIQUIDISING	LIQUIDIZING
LITRES	LITERS
LOCALISE	LOCALIZE
LOCALISED	LOCALIZED
LOCALISES	LOCALIZES
LOCALISING	LOCALIZING
LOUVRE	LOUVER
LOUVRED	LOUVERED
LOUVRES	LOUVERS
LUSTRE	LUSTER
MAGNETISE	MAGNETIZE
MAGNETISED	MAGNETIZED
MAGNETISES	MAGNETIZES
MAGNETISING	MAGNETIZING
MANOEUVRABILITY	MANEUVERABILITY
MANOEUVRABLE	MANEUVERABLE
MANOEUVRED	MANEUVERED
MANOEUVRES	MANEUVERS
MANOEUVRING	MANEUVERING
MANOEUVRINGS	MANEUVERINGS
MARGINALISATION	MARGINALIZATION
MARGINALISE	MARGINALIZE
MARGINALISED	MARGINALIZED
MARGINALISES	MARGINALIZES
MARGINALISING	MARGINALIZING
MARSHALLED	MARSHALED
MARSHALLING	MARSHALING
MARVELLED	MARVELED
MARVELLING	MARVELING
MARVELLOUS	MARVELOUS
MARVELLOUSLY	MARVELOUSLY
MATERIALISATION	MATERIALIZATION
MATERIALISE	MATERIALIZE
MATERIALISED	MATERIALIZED
MATERIALISES	MATERIALIZES
MATERIALISING	MATERIALIZING
MAXIMISATION	MAXIMIZATION
MAXIMISE	MAXIMIZE
MAXIMISED	MAXIMIZED
MAXIMISES	MAXIMIZES
MAXIMISING	MAXIMIZING
MEAGRE	MEAGER
MECHANISATION	MECHANIZATION
MECHANISE	MECHANIZE
MECHANISED	MECHANIZED
MECHANISES	MECHANIZES
MECHANISING	MECHANIZING
MEDIAEVAL	MEDIEVAL
MEMORIALISE	MEMORIALIZE
MEMORIALISED	MEMORIALIZED
MEMORIALISES	MEMORIALIZES
MEMORIALISING	MEMORIALIZING
MEMORISE	MEMORIZE
MEMORISED	MEMORIZED
MEMORISES	MEMORIZES
MEMORISING	MEMORIZING
MESMERISE	MESMERIZE
MESMERISED	MESMERIZED
MESMERISES	MESMERIZES
MESMERISING	MESMERIZING
METABOLISE	METABOLIZE
METABOLISED	METABOLIZED
METABOLISES	METABOLIZES
METABOLISING	METABOLIZING
MICROMETRE	MICROMETER
MICROMETRES	MICROMETERS
MILITARISE	MILITARIZE
MILITARISED	MILITARIZED
MILITARISES	MILITARIZES
MILITARISING	MILITARIZING
MILLIGRAMME	MILLIGRAM
MILLIGRAMMES	MILLIGRAMS
MILLILITRE	MILLILITER
MILLILITRES	MILLILITERS
MINIATURISATION	MINIATURIZATION
MINIATURISE	MINIATURIZE
MINIATURISED	MINIATURIZED
MINIATURISES	MINIATURIZES
MINIATURISING	MINIATURIZING
MINIBUSES	MINIBUSSES
MINIMISE	MINIMIZE
MINIMISED	MINIMIZED
MINIMISES	MINIMIZES
MINIMISING	MINIMIZING
MISBEHAVIOUR	MISBEHAVIOR
MISDEMEANOUR	MISDEMEANOR
MISDEMEANOURS	MISDEMEANORS
MISSPELT	MISSPELLED
MITRE	MITER
MITRES	MITERS
MOBILISATION	MOBILIZATION
MOBILISE	MOBILIZE
MOBILISED	MOBILIZED
MOBILISES	MOBILIZES
MOBILISING	MOBILIZING
MODELLED	MODELED
MODELLER	MODELER
MODELLERS	MODELERS
MODELLING	MODELING
MODERNISE	MODERNIZE
MODERNISED	MODERNIZED
MODERNISES	MODERNIZES
MODERNISING	MODERNIZING
MOISTURISE	MOISTURIZE
MOISTURISED	MOISTURIZED
MOISTURISER	MOISTURIZER
MOISTURISERS	MOISTURIZERS
MOISTURISES	MOISTURIZES
MOISTURISING	MOISTURIZING
MONOLOGUE	MONOLOG
MONOLOGUES	MONOLOGS
MONOPOLISATION	MONOPOLIZATION
MONOPOLISE	MONOPOLIZE
MONOPOLISED	MONOPOLIZED
MONOPOLISES	MONOPOLIZES
MONOPOLISING	MONOPOLIZING
MORALISE	MORALIZE
MORALISED	MORALIZED
MORALISES	MORALIZES
MORALISING	MORALIZING
MOTORISED	MOTORIZED
MOULD	MOLD
MOULDED	MOLDED
MOULDER	MOLDER
MOULDERED	MOLDERED
MOULDERING	MOLDERING
MOULDERS	MOLDERS
MOULDIER	MOLDIER
MOULDIEST	MOLDIEST
MOULDING	MOLDING
MOULDINGS	MOLDINGS
MOULDS	MOLDS
MOULDY	MOLDY
MOULT	MOLT
MOULTED	MOLTED
MOULTING	MOLTING
MOULTS	MOLTS
MOUSTACHE	MUSTACHE
MOUSTACHED	MUSTACHED
MOUSTACHES	MUSTACHES
MOUSTACHIOED	MUSTACHIOED
MULTICOLOURED	MULTICOLORED
NATIONALISATION	NATIONALIZATION
NATIONALISATIONS	NATIONALIZATIONS
NATIONALISE	NATIONALIZE
NATIONALISED	NATIONALIZED
NATIONALISES	NATIONALIZES
NATIONALISING	NATIONALIZING
NATURALISATION	NATURALIZATION
NATURALISE	NATURALIZE
NATURALISED	NATURALIZED
NATURALISES	NATURALIZES
NATURALISING	NATURALIZING
NEIGHBOUR	NEIGHBOR
NEIGHBOURHOODS	NEIGHBORHOODS
NEIGHBOURING	NEIGHBORING
NEIGHBOURLINESS	NEIGHBORLINESS
NEIGHBOURLY	NEIGHBORLY
NEIGHBOURS	NEIGHBORS
NEUTRALISATION	NEUTRALIZATION
NEUTRALISE	NEUTRALIZE
NEUTRALISED	NEUTRALIZED
NEUTRALISES	NEUTRALIZES
NEUTRALISING	NEUTRALIZING
NORMALISATION	NORMALIZATION
NORMALISE	NORMALIZE
NORMALISED	NORMALIZED
NORMALISES	NORMALIZES
NORMALISING	NORMALIZING
ODOUR	ODOR
ODOURLESS	ODORLESS
ODOURS	ODORS
OESOPHAGUS	ESOPHAGUS
OESOPHAGUSES	ESOPHAGUSES
OFFENCES	OFFENSES
OMELETTE	OMELET
OMELETTES	OMELETS
OPTIMISE	OPTIMIZE
OPTIMISED	OPTIMIZED
OPTIMISES	OPTIMIZES
OPTIMISING	OPTIMIZING
ORGANISATIONAL	ORGANIZATIONAL
ORGANISED	ORGANIZED
ORGANISER	ORGANIZER
ORGANISERS	ORGANIZERS
ORGANISES	ORGANIZES
ORGANISING	ORGANIZING
ORTHOPAEDIC	ORTHOPEDIC
ORTHOPAEDICS	ORTHOPEDICS
OSTRACISE	OSTRACIZE
OSTRACISED	OSTRACIZED
OSTRACISES	OSTRACIZES
OSTRACISING	OSTRACIZING
OUTMANOEUVRE	OUTMANEUVER
OUTMANOEUVRED	OUTMANEUVERED
OUTMANOEUVRES	OUTMANEUVERS
OUTMANOEUVRING	OUTMANEUVERING
OVEREMPHASISE	OVEREMPHASIZE
OVEREMPHASISED	OVEREMPHASIZED
OVEREMPHASISES	OVEREMPHASIZES
OVEREMPHASISING	OVEREMPHASIZING
OXIDISATION	OXIDIZATION
OXIDISE	OXIDIZE
OXIDISED	OXIDIZED
OXIDISES	OXIDIZES
OXIDISING	OXIDIZING
PAEDERAST	PEDERAST
PAEDERASTS	PEDERASTS
PAEDIATRIC	PEDIATRIC
PAEDIATRICIAN	PEDIATRICIAN
PAEDIATRICIANS	PEDIATRICIANS
PAEDIATRICS	PEDIATRICS
PAEDOPHILE	PEDOPHILE
PAEDOPHILES	PEDOPHILES
PAEDOPHILIA	PEDOPHILIA
PALAEOLITHIC	PALEOLITHIC
PALAEONTOLOGIST	PALEONTOLOGIST
PALAEONTOLOGISTS	PALEONTOLOGISTS
PALAEONTOLOGY	PALEONTOLOGY
PANELLED	PANELED
PANELLING	PANELING
PANELLIST	PANELIST
PANELLISTS	PANELISTS
PARALYSED	PARALYZED
PARALYSES	PARALYZES
PARALYSING	PARALYZING
PARCELLED	PARCELED
PARCELLING	PARCELING
PARLOUR	PARLOR
PARLOURS	PARLORS
PARTICULARISE	PARTICULARIZE
PARTICULARISED	PARTICULARIZED
PARTICULARISES	PARTICULARIZES
PARTICULARISING	PARTICULARIZING
PASSIVISATION	PASSIVIZATION
PASSIVISE	PASSIVIZE
PASSIVISED	PASSIVIZED
PASSIVISES	PASSIVIZES
PASSIVISING	PASSIVIZING
PASTEURISATION	PASTEURIZATION
PASTEURISE	PASTEURIZE
PASTEURISED	PASTEURIZED
PASTEURISES	PASTEURIZES
PASTEURISING	PASTEURIZING
PATRONISE	PATRONIZE
PATRONISED	PATRONIZED
PATRONISES	PATRONIZES
PATRONISING	PATRONIZING
PATRONISINGLY	PATRONIZINGLY
PEDALLED	PEDALED
PEDALLING	PEDALING
PEDESTRIANISATION	PEDESTRIANIZATION
PEDESTRIANISE	PEDESTRIANIZE
PEDESTRIANISED	PEDESTRIANIZED
PEDESTRIANISES	PEDESTRIANIZES
PEDESTRIANISING	PEDESTRIANIZING
PENALISE	PENALIZE
PENALISED	PENALIZED
PENALISES	PENALIZES
PENALISING	PENALIZING
PENCILLED	PENCILED
PENCILLING	PENCILING
PERSONALISE	PERSONALIZE
PERSONALISED	PERSONALIZED
PERSONALISES	PERSONALIZES
PERSONALISING	PERSONALIZING
PHARMACOPOEIA	PHARMACOPEIA
PHARMACOPOEIAS	PHARMACOPEIAS
PHILOSOPHISE	PHILOSOPHIZE
PHILOSOPHISED	PHILOSOPHIZED
PHILOSOPHISES	PHILOSOPHIZES
PHILOSOPHISING	PHILOSOPHIZING
PHILTRE	FILTER
PHILTRES	FILTERS
PHONEY	PHONY
PLAGIARISE	PLAGIARIZE
PLAGIARISED	PLAGIARIZED
PLAGIARISES	PLAGIARIZES
PLAGIARISING	PLAGIARIZING
PLOUGH	PLOW
PLOUGHED	PLOWED
PLOUGHING	PLOWING
PLOUGHMAN	PLOWMAN
PLOUGHMEN	PLOWMEN
PLOUGHS	PLOWS
PLOUGHSHARE	PLOWSHARE
PLOUGHSHARES	PLOWSHARES
POLARISATION	POLARIZATION
POLARISE	POLARIZE
POLARISED	POLARIZED
POLARISES	POLARIZES
POLARISING	POLARIZING
POLITICISATION	POLITICIZATION
POLITICISE	POLITICIZE
POLITICISED	POLITICIZED
POLITICISES	POLITICIZES
POLITICISING	POLITICIZING
POPULARISATION	POPULARIZATION
POPULARISE	POPULARIZE
POPULARISED	POPULARIZED
POPULARISES	POPULARIZES
POPULARISING	POPULARIZING
POUFFE	POUF
POUFFES	POUFS
PRACTISES	PRACTICES
PRACTISING	PRACTICING
PRAESIDIUM	PRESIDIUM
PRAESIDIUMS	PRESIDIUMS
PRESSURISATION	PRESSURIZATION
PRESSURISE	PRESSURIZE
PRESSURISED	PRESSURIZED
PRESSURISES	PRESSURIZES
PRESSURISING	PRESSURIZING
PRETENCE	PRETENSE
PRETENCES	PRETENSES
PRIMAEVAL	PRIMEVAL
PRIORITISATION	PRIORITIZATION
PRIORITISE	PRIORITIZE
PRIORITISED	PRIORITIZED
PRIORITISES	PRIORITIZES
PRIORITISING	PRIORITIZING
PRIVATISATION	PRIVATIZATION
PRIVATISATIONS	PRIVATIZATIONS
PRIVATISE	PRIVATIZE
PRIVATISED	PRIVATIZED
PRIVATISES	PRIVATIZES
PRIVATISING	PRIVATIZING
PROFESSIONALISATION	PROFESSIONALIZATION
PROFESSIONALISE	PROFESSIONALIZE
PROFESSIONALISED	PROFESSIONALIZED
PROFESSIONALISES	PROFESSIONALIZES
PROFESSIONALISING	PROFESSIONALIZING
PROGRAMME	PROGRAM
PROGRAMMES	PROGRAMS
PROLOGUE	PROLOG
PROLOGUES	PROLOGS
PROPAGANDISE	PROPAGANDIZE
PROPAGANDISED	PROPAGANDIZED
PROPAGANDISES	PROPAGANDIZES
PROPAGANDISING	PROPAGANDIZING
PROSELYTISE	PROSELYTIZE
PROSELYTISED	PROSELYTIZED
PROSELYTISER	PROSELYTIZER
PROSELYTISERS	PROSELYTIZERS
PROSELYTISES	PROSELYTIZES
PROSELYTISING	PROSELYTIZING
PSYCHOANALYSE	PSYCHOANALYZE
PSYCHOANALYSED	PSYCHOANALYZED
PSYCHOANALYSES	PSYCHOANALYZES
PSYCHOANALYSING	PSYCHOANALYZING
PUBLICISE	PUBLICIZE
PUBLICISED	PUBLICIZED
PUBLICISES	PUBLICIZES
PUBLICISING	PUBLICIZING
PULVERISATION	PULVERIZATION
PULVERISE	PULVERIZE
PULVERISED	PULVERIZED
PULVERISES	PULVERIZES
PULVERISING	PULVERIZING
PUMMELLED	PUMMEL
PUMMELLING	PUMMELED
PYJAMA	PAJAMA
PYJAMAS	PAJAMAS
PZAZZ	PIZZAZZ
QUARRELLED	QUARRELED
QUARRELLING	QUARRELING
RADICALISE	RADICALIZE
RADICALISED	RADICALIZED
RADICALISES	RADICALIZES
RADICALISING	RADICALIZING
RANCOUR	RANCOR
RANDOMISE	RANDOMIZE
RANDOMISED	RANDOMIZED
RANDOMISES	RANDOMIZES
RANDOMISING	RANDOMIZING
RATIONALISATION	RATIONALIZATION
RATIONALISATIONS	RATIONALIZATIONS
RATIONALISE	RATIONALIZE
RATIONALISED	RATIONALIZED
RATIONALISES	RATIONALIZES
RATIONALISING	RATIONALIZING
RAVELLED	RAVELED
RAVELLING	RAVELING
REALISABLE	REALIZABLE
REALISATION	REALIZATION
REALISATIONS	REALIZATIONS
REALISE	REALIZE
REALISED	REALIZED
REALISES	REALIZES
REALISING	REALIZING
RECOGNISABLE	RECOGNIZABLE
RECOGNISABLY	RECOGNIZABLY
RECOGNISANCE	RECOGNIZANCE
RECOGNISED	RECOGNIZED
RECOGNISES	RECOGNIZES
RECOGNISING	RECOGNIZING
RECONNOITRE	RECONNOITER
RECONNOITRED	RECONNOITERED
RECONNOITRES	RECONNOITERS
RECONNOITRING	RECONNOITERING
REFUELLED	REFUELED
REFUELLING	REFUELING
REGULARISATION	REGULARIZATION
REGULARISE	REGULARIZE
REGULARISED	REGULARIZED
REGULARISES	REGULARIZES
REGULARISING	REGULARIZING
REMODELLED	REMODELED
REMODELLING	REMODELING
REMOULD	REMOLD
REMOULDED	REMOLDED
REMOULDING	REMOLDING
REMOULDS	REMOLDS
REORGANISATION	REORGANIZATION
REORGANISATIONS	REORGANIZATIONS
REORGANISE	REORGANIZE
REORGANISED	REORGANIZED
REORGANISES	REORGANIZES
REORGANISING	REORGANIZING
REVELLED	REVELED
REVELLER	REVELER
REVELLERS	REVELERS
REVELLING	REVELING
REVITALISE	REVITALIZE
REVITALISED	REVITALIZED
REVITALISES	REVITALIZES
REVITALISING	REVITALIZING
REVOLUTIONISE	REVOLUTIONIZE
REVOLUTIONISED	REVOLUTIONIZED
REVOLUTIONISES	REVOLUTIONIZES
REVOLUTIONISING	REVOLUTIONIZING
RHAPSODISE	RHAPSODIZE
RHAPSODISED	RHAPSODIZED
RHAPSODISES	RHAPSODIZES
RHAPSODISING	RHAPSODIZING
RIGOURS	RIGORS
RITUALISED	RITUALIZED
RIVALLED	RIVALED
RIVALLING	RIVALING
ROMANTICISE	ROMANTICIZE
ROMANTICISED	ROMANTICIZED
ROMANTICISES	ROMANTICIZES
ROMANTICISING	ROMANTICIZING
RUMOUR	RUMOR
RUMOURED	RUMORED
RUMOURS	RUMORS
SABRE	SABER
SABRES	SABERS
SALTPETRE	SALTPETER
SANITISE	SANITIZE
SANITISED	SANITIZED
SANITISES	SANITIZES
SANITISING	SANITIZING
SATIRISE	SATIRIZE
SATIRISED	SATIRIZED
SATIRISES	SATIRIZES
SATIRISING	SATIRIZING
SAVIOUR	SAVIOR
SAVIOURS	SAVIORS
SAVOUR	SAVOR
SAVOURED	SAVORED
SAVOURIES	SAVORIES
SAVOURING	SAVORING
SAVOURS	SAVORS
SAVOURY	SAVORY
SCANDALISE	SCANDALIZE
SCANDALISED	SCANDALIZED
SCANDALISES	SCANDALIZES
SCANDALISING	SCANDALIZING
SCEPTIC	SKEPTIC
SCEPTICAL	SKEPTICAL
SCEPTICALLY	SKEPTICALLY
SCEPTICS	SKEPTICS
SCEPTRE	SCEPTER
SCEPTRES	SCEPTERS
SCRUTINISE	SCRUTINIZE
SCRUTINISED	SCRUTINIZED
SCRUTINISES	SCRUTINIZES
SCRUTINISING	SCRUTINIZING
SECULARISATION	SECULARIZATION
SECULARISE	SECULARIZE
SECULARISED	SECULARIZED
SECULARISES	SECULARIZES
SECULARISING	SECULARIZING
SENSATIONALISE	SENSATIONALIZE
SENSATIONALISED	SENSATIONALIZED
SENSATIONALISES	SENSATIONALIZES
SENSATIONALISING	SENSATIONALIZING
SENSITISE	SENSITIZE
SENSITISED	SENSITIZED
SENSITISES	SENSITIZES
SENSITISING	SENSITIZING
SENTIMENTALISE	SENTIMENTALIZE
SENTIMENTALISED	SENTIMENTALIZED
SENTIMENTALISES	SENTIMENTALIZES
SENTIMENTALISING	SENTIMENTALIZING
SEPULCHRE	SEPULCHER
SEPULCHRES	SEPULCHERS
SERIALISATION	SERIALIZATION
SERIALISATIONS	SERIALIZATIONS
SERIALISE	SERIALIZE
SERIALISED	SERIALIZED
SERIALISES	SERIALIZES
SERIALISING	SERIALIZING
SERMONISE	SERMONIZE
SERMONISED	SERMONIZED
SERMONISES	SERMONIZES
SERMONISING	SERMONIZING
SHEIKH	SHEIK
SHOVELLED	SHOVELED
SHOVELLING	SHOVELING
SHRIVELLED	SHRIVELED
SHRIVELLING	SHRIVELING
SIGNALISE	SIGNALIZE
SIGNALISED	SIGNALIZED
SIGNALISES	SIGNALIZES
SIGNALISING	SIGNALIZING
SIGNALLED	SIGNALED
SIGNALLING	SIGNALING
SMOULDER	SMOLDER
SMOULDERED	SMOLDERED
SMOULDERING	SMOLDERING
SMOULDERS	SMOLDERS
SNIVELLED	SNIVELED
SNIVELLING	SNIVELING
SNORKELLED	SNORKELED
SNORKELLING	SNORKELING
SNOWPLOUGH	SNOWPLOW
SNOWPLOUGHS	SNOWPLOW
SOCIALISATION	SOCIALIZATION
SOCIALISE	SOCIALIZE
SOCIALISED	SOCIALIZED
SOCIALISES	SOCIALIZES
SOCIALISING	SOCIALIZING
SODOMISE	SODOMIZE
SODOMISED	SODOMIZED
SODOMISES	SODOMIZES
SODOMISING	SODOMIZING
SOLEMNISE	SOLEMNIZE
SOLEMNISED	SOLEMNIZED
SOLEMNISES	SOLEMNIZES
SOLEMNISING	SOLEMNIZING
SOMBRE	SOMBER
SPECIALISATION	SPECIALIZATION
SPECIALISATIONS	SPECIALIZATIONS
SPECIALISE	SPECIALIZE
SPECIALISED	SPECIALIZED
SPECIALISES	SPECIALIZES
SPECIALISING	SPECIALIZING
SPECTRE	SPECTER
SPECTRES	SPECTERS
SPIRALLED	SPIRALED
SPIRALLING	SPIRALING
SPLENDOURS	SPLENDORS
SQUIRRELLED	SQUIRRELED
SQUIRRELLING	SQUIRRELING
STABILISATION	STABILIZATION
STABILISE	STABILIZE
STABILISED	STABILIZED
STABILISER	STABILIZER
STABILISERS	STABILIZERS
STABILISES	STABILIZES
STABILISING	STABILIZING
STANDARDISATION	STANDARDIZATION
STANDARDISE	STANDARDIZE
STANDARDISED	STANDARDIZED
STANDARDISES	STANDARDIZES
STANDARDISING	STANDARDIZING
STENCILLED	STENCILED
STENCILLING	STENCILING
STERILISATION	STERILIZATION
STERILISATIONS	STERILIZATIONS
STERILISE	STERILIZE
STERILISED	STERILIZED
STERILISER	STERILIZER
STERILISERS	STERILIZERS
STERILISES	STERILIZES
STERILISING	STERILIZING
STIGMATISATION	STIGMATIZATION
STIGMATISE	STIGMATIZE
STIGMATISED	STIGMATIZED
STIGMATISES	STIGMATIZES
STIGMATISING	STIGMATIZING
STOREY	STORY
STOREYS	STORIES
SUBSIDISATION	SUBSIDIZATION
SUBSIDISE	SUBSIDIZE
SUBSIDISED	SUBSIDIZED
SUBSIDISER	SUBSIDIZER
SUBSIDISERS	SUBSIDIZERS
SUBSIDISES	SUBSIDIZES
SUBSIDISING	SUBSIDIZING
SUCCOUR	SUCCOR
SUCCOURED	SUCCORED
SUCCOURING	SUCCORING
SUCCOURS	SUCCORS
SULPHATE	SULFATE
SULPHATES	SULFATES
SULPHIDE	SULFIDE
SULPHIDES	SULFIDES
SULPHUR	SULFUR
SULPHUROUS	SULFUROUS
SUMMARISED	SUMMARIZED
SUMMARISES	SUMMARIZES
SUMMARISING	SUMMARIZING
SWIVELLED	SWIVELED
SWIVELLING	SWIVELING
SYMBOLISE	SYMBOLIZE
SYMBOLISED	SYMBOLIZED
SYMBOLISES	SYMBOLIZES
SYMBOLISING	SYMBOLIZING
SYMPATHISE	SYMPATHIZE
SYMPATHISED	SYMPATHIZED
SYMPATHISER	SYMPATHIZER
SYMPATHISERS	SYMPATHIZERS
SYMPATHISES	SYMPATHIZES
SYMPATHISING	SYMPATHIZING
SYNCHRONISATION	SYNCHRONIZATION
SYNCHRONISE	SYNCHRONIZE
SYNCHRONISED	SYNCHRONIZED
SYNCHRONISES	SYNCHRONIZES
SYNCHRONISING	SYNCHRONIZING
SYNTHESISE	SYNTHESIZE
SYNTHESISED	SYNTHESIZED
SYNTHESISER	SYNTHESIZER
SYNTHESISERS	SYNTHESIZERS
SYNTHESISES	SYNTHESIZES
SYNTHESISING	SYNTHESIZING
SYPHON	SIPHON
SYPHONED	SIPHONED
SYPHONING	SIPHONING
SYPHONS	SIPHONS
SYSTEMATISATION	SYSTEMATIZATION
SYSTEMATISE	SYSTEMATIZE
SYSTEMATISED	SYSTEMATIZED
SYSTEMATISES	SYSTEMATIZES
SYSTEMATISING	SYSTEMATIZING
TANTALISE	TANTALIZE
TANTALISED	TANTALIZED
TANTALISES	TANTALIZES
TANTALISING	TANTALIZING
TANTALISINGLY	TANTALIZINGLY
TASSELLED	TASSELED
TECHNICOLOUR	TECHNICOLOR
TEMPORISE	TEMPORIZE
TEMPORISED	TEMPORIZED
TEMPORISES	TEMPORIZES
TEMPORISING	TEMPORIZING
TENDERISE	TENDERIZE
TENDERISED	TENDERIZED
TENDERISES	TENDERIZES
TENDERISING	TENDERIZING
TERRORISE	TERRORIZE
TERRORISED	TERRORIZED
TERRORISES	TERRORIZES
TERRORISING	TERRORIZING
THEATREGOER	THEATERGOER
THEATREGOERS	THEATERGOERS
THEATRES	THEATERS
THEORISE	THEORIZE
THEORISED	THEORIZED
THEORISES	THEORIZES
THEORISING	THEORIZING
TONNE	TON
TONNES	TONS
TOWELLED	TOWELED
TOWELLING	TOWELING
TOXAEMIA	TOXEMIA
TRANQUILLISE	TRANQUILIZE
TRANQUILLISED	TRANQUILIZED
TRANQUILLISER	TRANQUILIZER
TRANQUILLISERS	TRANQUILIZERS
TRANQUILLISES	TRANQUILIZES
TRANQUILLISING	TRANQUILIZING
TRANQUILLITY	TRANQUILITY
TRANQUILLIZE	TRANQUILIZE
TRANQUILLIZED	TRANQUILIZED
TRANQUILLIZER	TRANQUILIZER
TRANQUILLIZERS	TRANQUILIZERS
TRANQUILLIZES	TRANQUILIZES
TRANQUILLIZING	TRANQUILIZING
TRANQUILLY	TRANQUILITY
TRANSISTORISED	TRANSISTORIZED
TRAUMATISE	TRAUMATIZE
TRAUMATISED	TRAUMATIZED
TRAUMATISES	TRAUMATIZES
TRAUMATISING	TRAUMATIZING
TRAVELLERS	TRAVELERS
TRAVELOGUE	TRAVELOG
TRAVELOGUES	TRAVELOGS
TRIALLED	TRIALED
TRIALLING	TRIALING
TRICOLOUR	TRICOLOR
TRICOLOURS	TRICOLORS
TRIVIALISE	TRIVIALIZE
TRIVIALISED	TRIVIALIZED
TRIVIALISES	TRIVIALIZES
TRIVIALISING	TRIVIALIZING
TUMOUR	TUMOR
TUMOURS	TUMORS
TUNNELLED	TUNNELED
TUNNELLING	TUNNELING
TYRANNISE	TYRANNIZE
TYRANNISED	TYRANNIZED
TYRANNISES	TYRANNIZES
TYRANNISING	TYRANNIZING
TYRE	TIRE
TYRES	TIRES
UNAUTHORISED	UNAUTHORIZED
UNCIVILISED	UNCIVILIZED
UNDERUTILISED	UNDERUTILIZED
UNEQUALLED	UNEQUALED
UNFAVOURABLE	UNFAVORABLE
UNFAVOURABLY	UNFAVORABLY
UNIONISATION	UNIONIZATION
UNIONISE	UNIONIZE
UNIONISED	UNIONIZED
UNIONISES	UNIONIZES
UNIONISING	UNIONIZING
UNORGANISED	UNORGANIZED
UNRAVELLED	UNRAVELED
UNRAVELLING	UNRAVELING
UNRECOGNISABLE	UNRECOGNIZABLE
UNRECOGNISED	UNRECOGNIZED
UNRIVALLED	UNRIVALED
UNSAVOURY	UNSAVORY
UNTRAMMELLED	UNTRAMMELED
URBANISATION	URBANIZATION
URBANISE	URBANIZE
URBANISED	URBANIZED
URBANISES	URBANIZES
URBANISING	URBANIZING
UTILISABLE	UTILIZABLE
UTILISATION	UTILIZATION
UTILISE	UTILIZE
UTILISED	UTILIZED
UTILISES	UTILIZES
UTILISING	UTILIZING
VALOUR	VALOR
VANDALISE	VANDALIZE
VANDALISED	VANDALIZED
VANDALISES	VANDALIZES
VANDALISING	VANDALIZING
VAPORISATION	VAPORIZATION
VAPORISE	VAPORIZE
VAPORISED	VAPORIZED
VAPORISES	VAPORIZES
VAPORISING	VAPORIZING
VAPOUR	VAPOR
VAPOURS	VAPORS
VERBALISE	VERBALIZE
VERBALISED	VERBALIZED
VERBALISES	VERBALIZES
VERBALISING	VERBALIZING
VICTIMISATION	VICTIMIZATION
VICTIMISE	VICTIMIZE
VICTIMISED	VICTIMIZED
VICTIMISES	VICTIMIZES
VICTIMISING	VICTIMIZING
VIDEODISC	VIDEODISK
VIDEODISCS	VIDEODISKS
VIGOUR	VIGOR
VISUALISATION	VISUALIZATION
VISUALISATIONS	VISUALIZATIONS
VISUALISE	VISUALIZE
VISUALISED	VISUALIZED
VISUALISES	VISUALIZES
VISUALISING	VISUALIZING
VOCALISATION	VOCALIZATION
VOCALISATIONS	VOCALIZATIONS
VOCALISE	VOCALIZE
VOCALISED	VOCALIZED
VOCALISES	VOCALIZES
VOCALISING	VOCALIZING
VULCANISED	VULCANIZED
VULGARISATION	VULGARIZATION
VULGARISE	VULGARIZE
VULGARISED	VULGARIZED
VULGARISES	VULGARIZES
VULGARISING	VULGARIZING
WAGGON	WAGON
WAGGONS	WAGONS
WATERCOLOUR	WATERCOLOR
WATERCOLOURS	WATERCOLORS
WEASELLED	WEASELED
WEASELLING	WEASELING
WESTERNISATION	WESTERNIZATION
WESTERNISE	WESTERNIZE
WESTERNISED	WESTERNIZED
WESTERNISES	WESTERNIZES
WESTERNISING	WESTERNIZING
WOMANISE	WOMANIZE
WOMANISED	WOMANIZED
WOMANISER	WOMANIZER
WOMANISERS	WOMANIZERS
WOMANISES	WOMANIZES
WOMANISING	WOMANIZING
WOOLLEN	WOOLEN
WOOLLENS	WOOLENS
WOOLLIES	WOOLIES
WOOLLY	WOOLY
WORSHIPPED	WORSHIPED
WORSHIPPING	WORSHIPING
WORSHIPPER	WORSHIPER
YODELLED	YODELED
YODELLING	YODELING
YOGHOURT	YOGURT
YOGHOURTS	YOGURTS
YOGHURT	YOGURT
YOGHURT	YOGURT
