I	one
II	two
III	three
IV	four
V	five
VI	six
VII	seven
VIII	eight
IX	nine
X	ten
XI	eleven
XII	twelve
XIII	thirteen
XIV	fourteen
XV	fifteen
XVI	sixteen
XVII	seventeen
XVIII	eighteen
XIX	nineteen
XX	twenty
XXI	twenty one
XXII	twenty two
XXIII	twenty three
XXIV	twenty four
XXV	twenty five
XXVI	twenty six
XXVII	twenty seven
XXVIII	twenty eight
XXIX	twenty nine
XXX	thirty
XXXI	thirty one
XXXII	thirty two
XXXIII	thirty three
XXXIV	thirty four
XXXV	thirty five
XXXVI	thirty six
XXXVII	thirty seven
XXXVIII	thirty eight
XXXIX	thirty nine
XL	forty
XLI	forty one
XLII	forty two
XLIII	forty three
XLIV	forty four
XLV	forty five
XLVI	forty six
XLVII	forty seven
XLVIII	forty eight
XLIX	forty nine
L	fifty
LI	fifty one
LII	fifty two
LIII	fifty three
LIV	fifty four
LV	fifty five
LVI	fifty six
LVII	fifty seven
LVIII	fifty eight
LIX	fifty nine
LX	sixty
LXI	sixty one
LXII	sixty two
LXIII	sixty three
LXIV	sixty four
LXV	sixty five
LXVI	sixty six
LXVII	sixty seven
LXVIII	sixty eight
LXIX	sixty nine
LXX	seventy
LXXI	seventy one
LXXII	seventy two
LXXIII	seventy three
LXXIV	seventy four
LXXV	seventy five
LXXVI	seventy six
LXXVII	seventy seven
LXXVIII	seventy eight
LXXIX	seventy nine
LXXX	eighty
LXXXI	eighty one
LXXXII	eighty two
LXXXIII	eighty three
LXXXIV	eighty four
LXXXV	eighty five
LXXXVI	eighty six
LXXXVII	eighty seven
LXXXVIII	eighty eight
LXXXIX	eighty nine
XC	ninety
XCI	ninety one
XCII	ninety two
XCIII	ninety three
XCIV	ninety four
XCV	ninety five
XCVI	ninety six
XCVII	ninety seven
XCVIII	ninety eight
XCIX	ninety nine
C	one hundred
CI	one hundred one
CII	one hundred two
CIII	one hundred three
CIV	one hundred four
CV	one hundred five
CVI	one hundred six
CVII	one hundred seven
CVIII	one hundred eight
CIX	one hundred nine
CX	one hundred ten
CXI	one hundred eleven
CXII	one hundred twelve
CXIII	one hundred thirteen
CXIV	one hundred fourteen
CXV	one hundred fifteen
CXVI	one hundred sixteen
CXVII	one hundred seventeen
CXVIII	one hundred eighteen
CXIX	one hundred nineteen
CXX	one hundred twenty
CXXI	one hundred twenty one
CXXII	one hundred twenty two
CXXIII	one hundred twenty three
CXXIV	one hundred twenty four
CXXV	one hundred twenty five
CXXVI	one hundred twenty six
CXXVII	one hundred twenty seven
CXXVIII	one hundred twenty eight
CXXIX	one hundred twenty nine
CXXX	one hundred thirty
CXXXI	one hundred thirty one
CXXXII	one hundred thirty two
CXXXIII	one hundred thirty three
CXXXIV	one hundred thirty four
CXXXV	one hundred thirty five
CXXXVI	one hundred thirty six
CXXXVII	one hundred thirty seven
CXXXVIII	one hundred thirty eight
CXXXIX	one hundred thirty nine
CXL	one hundred forty
CXLI	one hundred forty one
CXLII	one hundred forty two
CXLIII	one hundred forty three
CXLIV	one hundred forty four
CXLV	one hundred forty five
CXLVI	one hundred forty six
CXLVII	one hundred forty seven
CXLVIII	one hundred forty eight
CXLIX	one hundred forty nine
CL	one hundred fifty
CLI	one hundred fifty one
CLII	one hundred fifty two
CLIII	one hundred fifty three
CLIV	one hundred fifty four
CLV	one hundred fifty five
CLVI	one hundred fifty six
CLVII	one hundred fifty seven
CLVIII	one hundred fifty eight
CLIX	one hundred fifty nine
CLX	one hundred sixty
CLXI	one hundred sixty one
CLXII	one hundred sixty two
CLXIII	one hundred sixty three
CLXIV	one hundred sixty four
CLXV	one hundred sixty five
CLXVI	one hundred sixty six
CLXVII	one hundred sixty seven
CLXVIII	one hundred sixty eight
CLXIX	one hundred sixty nine
CLXX	one hundred seventy
CLXXI	one hundred seventy one
CLXXII	one hundred seventy two
CLXXIII	one hundred seventy three
CLXXIV	one hundred seventy four
CLXXV	one hundred seventy five
CLXXVI	one hundred seventy six
CLXXVII	one hundred seventy seven
CLXXVIII	one hundred seventy eight
CLXXIX	one hundred seventy nine
CLXXX	one hundred eighty
CLXXXI	one hundred eighty one
CLXXXII	one hundred eighty two
CLXXXIII	one hundred eighty three
CLXXXIV	one hundred eighty four
CLXXXV	one hundred eighty five
CLXXXVI	one hundred eighty six
CLXXXVII	one hundred eighty seven
CLXXXVIII	one hundred eighty eight
CLXXXIX	one hundred eighty nine
CXC	one hundred ninety
CXCI	one hundred ninety one
CXCII	one hundred ninety two
CXCIII	one hundred ninety three
CXCIV	one hundred ninety four
CXCV	one hundred ninety five
CXCVI	one hundred ninety six
CXCVII	one hundred ninety seven
CXCVIII	one hundred ninety eight
CXCIX	one hundred ninety nine
CC	two hundred
CCI	two hundred one
CCII	two hundred two
CCIII	two hundred three
CCIV	two hundred four
CCV	two hundred five
CCVI	two hundred six
CCVII	two hundred seven
CCVIII	two hundred eight
CCIX	two hundred nine
CCX	two hundred ten
CCXI	two hundred eleven
CCXII	two hundred twelve
CCXIII	two hundred thirteen
CCXIV	two hundred fourteen
CCXV	two hundred fifteen
CCXVI	two hundred sixteen
CCXVII	two hundred seventeen
CCXVIII	two hundred eighteen
CCXIX	two hundred nineteen
CCXX	two hundred twenty
CCXXI	two hundred twenty one
CCXXII	two hundred twenty two
CCXXIII	two hundred twenty three
CCXXIV	two hundred twenty four
CCXXV	two hundred twenty five
CCXXVI	two hundred twenty six
CCXXVII	two hundred twenty seven
CCXXVIII	two hundred twenty eight
CCXXIX	two hundred twenty nine
CCXXX	two hundred thirty
CCXXXI	two hundred thirty one
CCXXXII	two hundred thirty two
CCXXXIII	two hundred thirty three
CCXXXIV	two hundred thirty four
CCXXXV	two hundred thirty five
CCXXXVI	two hundred thirty six
CCXXXVII	two hundred thirty seven
CCXXXVIII	two hundred thirty eight
CCXXXIX	two hundred thirty nine
CCXL	two hundred forty
CCXLI	two hundred forty one
CCXLII	two hundred forty two
CCXLIII	two hundred forty three
CCXLIV	two hundred forty four
CCXLV	two hundred forty five
CCXLVI	two hundred forty six
CCXLVII	two hundred forty seven
CCXLVIII	two hundred forty eight
CCXLIX	two hundred forty nine
CCL	two hundred fifty
CCLI	two hundred fifty one
CCLII	two hundred fifty two
CCLIII	two hundred fifty three
CCLIV	two hundred fifty four
CCLV	two hundred fifty five
CCLVI	two hundred fifty six
CCLVII	two hundred fifty seven
CCLVIII	two hundred fifty eight
CCLIX	two hundred fifty nine
CCLX	two hundred sixty
CCLXI	two hundred sixty one
CCLXII	two hundred sixty two
CCLXIII	two hundred sixty three
CCLXIV	two hundred sixty four
CCLXV	two hundred sixty five
CCLXVI	two hundred sixty six
CCLXVII	two hundred sixty seven
CCLXVIII	two hundred sixty eight
CCLXIX	two hundred sixty nine
CCLXX	two hundred seventy
CCLXXI	two hundred seventy one
CCLXXII	two hundred seventy two
CCLXXIII	two hundred seventy three
CCLXXIV	two hundred seventy four
CCLXXV	two hundred seventy five
CCLXXVI	two hundred seventy six
CCLXXVII	two hundred seventy seven
CCLXXVIII	two hundred seventy eight
CCLXXIX	two hundred seventy nine
CCLXXX	two hundred eighty
CCLXXXI	two hundred eighty one
CCLXXXII	two hundred eighty two
CCLXXXIII	two hundred eighty three
CCLXXXIV	two hundred eighty four
CCLXXXV	two hundred eighty five
CCLXXXVI	two hundred eighty six
CCLXXXVII	two hundred eighty seven
CCLXXXVIII	two hundred eighty eight
CCLXXXIX	two hundred eighty nine
CCXC	two hundred ninety
CCXCI	two hundred ninety one
CCXCII	two hundred ninety two
CCXCIII	two hundred ninety three
CCXCIV	two hundred ninety four
CCXCV	two hundred ninety five
CCXCVI	two hundred ninety six
CCXCVII	two hundred ninety seven
CCXCVIII	two hundred ninety eight
CCXCIX	two hundred ninety nine
CCC	three hundred
CCCI	three hundred one
CCCII	three hundred two
CCCIII	three hundred three
CCCIV	three hundred four
CCCV	three hundred five
CCCVI	three hundred six
CCCVII	three hundred seven
CCCVIII	three hundred eight
CCCIX	three hundred nine
CCCX	three hundred ten
CCCXI	three hundred eleven
CCCXII	three hundred twelve
CCCXIII	three hundred thirteen
CCCXIV	three hundred fourteen
CCCXV	three hundred fifteen
CCCXVI	three hundred sixteen
CCCXVII	three hundred seventeen
CCCXVIII	three hundred eighteen
CCCXIX	three hundred nineteen
CCCXX	three hundred twenty
CCCXXI	three hundred twenty one
CCCXXII	three hundred twenty two
CCCXXIII	three hundred twenty three
CCCXXIV	three hundred twenty four
CCCXXV	three hundred twenty five
CCCXXVI	three hundred twenty six
CCCXXVII	three hundred twenty seven
CCCXXVIII	three hundred twenty eight
CCCXXIX	three hundred twenty nine
CCCXXX	three hundred thirty
CCCXXXI	three hundred thirty one
CCCXXXII	three hundred thirty two
CCCXXXIII	three hundred thirty three
CCCXXXIV	three hundred thirty four
CCCXXXV	three hundred thirty five
CCCXXXVI	three hundred thirty six
CCCXXXVII	three hundred thirty seven
CCCXXXVIII	three hundred thirty eight
CCCXXXIX	three hundred thirty nine
CCCXL	three hundred forty
CCCXLI	three hundred forty one
CCCXLII	three hundred forty two
CCCXLIII	three hundred forty three
CCCXLIV	three hundred forty four
CCCXLV	three hundred forty five
CCCXLVI	three hundred forty six
CCCXLVII	three hundred forty seven
CCCXLVIII	three hundred forty eight
CCCXLIX	three hundred forty nine
CCCL	three hundred fifty
CCCLI	three hundred fifty one
CCCLII	three hundred fifty two
CCCLIII	three hundred fifty three
CCCLIV	three hundred fifty four
CCCLV	three hundred fifty five
CCCLVI	three hundred fifty six
CCCLVII	three hundred fifty seven
CCCLVIII	three hundred fifty eight
CCCLIX	three hundred fifty nine
CCCLX	three hundred sixty
CCCLXI	three hundred sixty one
CCCLXII	three hundred sixty two
CCCLXIII	three hundred sixty three
CCCLXIV	three hundred sixty four
CCCLXV	three hundred sixty five
CCCLXVI	three hundred sixty six
CCCLXVII	three hundred sixty seven
CCCLXVIII	three hundred sixty eight
CCCLXIX	three hundred sixty nine
CCCLXX	three hundred seventy
CCCLXXI	three hundred seventy one
CCCLXXII	three hundred seventy two
CCCLXXIII	three hundred seventy three
CCCLXXIV	three hundred seventy four
CCCLXXV	three hundred seventy five
CCCLXXVI	three hundred seventy six
CCCLXXVII	three hundred seventy seven
CCCLXXVIII	three hundred seventy eight
CCCLXXIX	three hundred seventy nine
CCCLXXX	three hundred eighty
CCCLXXXI	three hundred eighty one
CCCLXXXII	three hundred eighty two
CCCLXXXIII	three hundred eighty three
CCCLXXXIV	three hundred eighty four
CCCLXXXV	three hundred eighty five
CCCLXXXVI	three hundred eighty six
CCCLXXXVII	three hundred eighty seven
CCCLXXXVIII	three hundred eighty eight
CCCLXXXIX	three hundred eighty nine
CCCXC	three hundred ninety
CCCXCI	three hundred ninety one
CCCXCII	three hundred ninety two
CCCXCIII	three hundred ninety three
CCCXCIV	three hundred ninety four
CCCXCV	three hundred ninety five
CCCXCVI	three hundred ninety six
CCCXCVII	three hundred ninety seven
CCCXCVIII	three hundred ninety eight
CCCXCIX	three hundred ninety nine
CD	four hundred
CDI	four hundred one
CDII	four hundred two
CDIII	four hundred three
CDIV	four hundred four
CDV	four hundred five
CDVI	four hundred six
CDVII	four hundred seven
CDVIII	four hundred eight
CDIX	four hundred nine
CDX	four hundred ten
CDXI	four hundred eleven
CDXII	four hundred twelve
CDXIII	four hundred thirteen
CDXIV	four hundred fourteen
CDXV	four hundred fifteen
CDXVI	four hundred sixteen
CDXVII	four hundred seventeen
CDXVIII	four hundred eighteen
CDXIX	four hundred nineteen
CDXX	four hundred twenty
CDXXI	four hundred twenty one
CDXXII	four hundred twenty two
CDXXIII	four hundred twenty three
CDXXIV	four hundred twenty four
CDXXV	four hundred twenty five
CDXXVI	four hundred twenty six
CDXXVII	four hundred twenty seven
CDXXVIII	four hundred twenty eight
CDXXIX	four hundred twenty nine
CDXXX	four hundred thirty
CDXXXI	four hundred thirty one
CDXXXII	four hundred thirty two
CDXXXIII	four hundred thirty three
CDXXXIV	four hundred thirty four
CDXXXV	four hundred thirty five
CDXXXVI	four hundred thirty six
CDXXXVII	four hundred thirty seven
CDXXXVIII	four hundred thirty eight
CDXXXIX	four hundred thirty nine
CDXL	four hundred forty
CDXLI	four hundred forty one
CDXLII	four hundred forty two
CDXLIII	four hundred forty three
CDXLIV	four hundred forty four
CDXLV	four hundred forty five
CDXLVI	four hundred forty six
CDXLVII	four hundred forty seven
CDXLVIII	four hundred forty eight
CDXLIX	four hundred forty nine
CDL	four hundred fifty
CDLI	four hundred fifty one
CDLII	four hundred fifty two
CDLIII	four hundred fifty three
CDLIV	four hundred fifty four
CDLV	four hundred fifty five
CDLVI	four hundred fifty six
CDLVII	four hundred fifty seven
CDLVIII	four hundred fifty eight
CDLIX	four hundred fifty nine
CDLX	four hundred sixty
CDLXI	four hundred sixty one
CDLXII	four hundred sixty two
CDLXIII	four hundred sixty three
CDLXIV	four hundred sixty four
CDLXV	four hundred sixty five
CDLXVI	four hundred sixty six
CDLXVII	four hundred sixty seven
CDLXVIII	four hundred sixty eight
CDLXIX	four hundred sixty nine
CDLXX	four hundred seventy
CDLXXI	four hundred seventy one
CDLXXII	four hundred seventy two
CDLXXIII	four hundred seventy three
CDLXXIV	four hundred seventy four
CDLXXV	four hundred seventy five
CDLXXVI	four hundred seventy six
CDLXXVII	four hundred seventy seven
CDLXXVIII	four hundred seventy eight
CDLXXIX	four hundred seventy nine
CDLXXX	four hundred eighty
CDLXXXI	four hundred eighty one
CDLXXXII	four hundred eighty two
CDLXXXIII	four hundred eighty three
CDLXXXIV	four hundred eighty four
CDLXXXV	four hundred eighty five
CDLXXXVI	four hundred eighty six
CDLXXXVII	four hundred eighty seven
CDLXXXVIII	four hundred eighty eight
CDLXXXIX	four hundred eighty nine
CDXC	four hundred ninety
CDXCI	four hundred ninety one
CDXCII	four hundred ninety two
CDXCIII	four hundred ninety three
CDXCIV	four hundred ninety four
CDXCV	four hundred ninety five
CDXCVI	four hundred ninety six
CDXCVII	four hundred ninety seven
CDXCVIII	four hundred ninety eight
CDXCIX	four hundred ninety nine
D	five hundred
DI	five hundred one
DII	five hundred two
DIII	five hundred three
DIV	five hundred four
DV	five hundred five
DVI	five hundred six
DVII	five hundred seven
DVIII	five hundred eight
DIX	five hundred nine
DX	five hundred ten
DXI	five hundred eleven
DXII	five hundred twelve
DXIII	five hundred thirteen
DXIV	five hundred fourteen
DXV	five hundred fifteen
DXVI	five hundred sixteen
DXVII	five hundred seventeen
DXVIII	five hundred eighteen
DXIX	five hundred nineteen
DXX	five hundred twenty
DXXI	five hundred twenty one
DXXII	five hundred twenty two
DXXIII	five hundred twenty three
DXXIV	five hundred twenty four
DXXV	five hundred twenty five
DXXVI	five hundred twenty six
DXXVII	five hundred twenty seven
DXXVIII	five hundred twenty eight
DXXIX	five hundred twenty nine
DXXX	five hundred thirty
DXXXI	five hundred thirty one
DXXXII	five hundred thirty two
DXXXIII	five hundred thirty three
DXXXIV	five hundred thirty four
DXXXV	five hundred thirty five
DXXXVI	five hundred thirty six
DXXXVII	five hundred thirty seven
DXXXVIII	five hundred thirty eight
DXXXIX	five hundred thirty nine
DXL	five hundred forty
DXLI	five hundred forty one
DXLII	five hundred forty two
DXLIII	five hundred forty three
DXLIV	five hundred forty four
DXLV	five hundred forty five
DXLVI	five hundred forty six
DXLVII	five hundred forty seven
DXLVIII	five hundred forty eight
DXLIX	five hundred forty nine
DL	five hundred fifty
DLI	five hundred fifty one
DLII	five hundred fifty two
DLIII	five hundred fifty three
DLIV	five hundred fifty four
DLV	five hundred fifty five
DLVI	five hundred fifty six
DLVII	five hundred fifty seven
DLVIII	five hundred fifty eight
DLIX	five hundred fifty nine
DLX	five hundred sixty
DLXI	five hundred sixty one
DLXII	five hundred sixty two
DLXIII	five hundred sixty three
DLXIV	five hundred sixty four
DLXV	five hundred sixty five
DLXVI	five hundred sixty six
DLXVII	five hundred sixty seven
DLXVIII	five hundred sixty eight
DLXIX	five hundred sixty nine
DLXX	five hundred seventy
DLXXI	five hundred seventy one
DLXXII	five hundred seventy two
DLXXIII	five hundred seventy three
DLXXIV	five hundred seventy four
DLXXV	five hundred seventy five
DLXXVI	five hundred seventy six
DLXXVII	five hundred seventy seven
DLXXVIII	five hundred seventy eight
DLXXIX	five hundred seventy nine
DLXXX	five hundred eighty
DLXXXI	five hundred eighty one
DLXXXII	five hundred eighty two
DLXXXIII	five hundred eighty three
DLXXXIV	five hundred eighty four
DLXXXV	five hundred eighty five
DLXXXVI	five hundred eighty six
DLXXXVII	five hundred eighty seven
DLXXXVIII	five hundred eighty eight
DLXXXIX	five hundred eighty nine
DXC	five hundred ninety
DXCI	five hundred ninety one
DXCII	five hundred ninety two
DXCIII	five hundred ninety three
DXCIV	five hundred ninety four
DXCV	five hundred ninety five
DXCVI	five hundred ninety six
DXCVII	five hundred ninety seven
DXCVIII	five hundred ninety eight
DXCIX	five hundred ninety nine
DC	six hundred
DCI	six hundred one
DCII	six hundred two
DCIII	six hundred three
DCIV	six hundred four
DCV	six hundred five
DCVI	six hundred six
DCVII	six hundred seven
DCVIII	six hundred eight
DCIX	six hundred nine
DCX	six hundred ten
DCXI	six hundred eleven
DCXII	six hundred twelve
DCXIII	six hundred thirteen
DCXIV	six hundred fourteen
DCXV	six hundred fifteen
DCXVI	six hundred sixteen
DCXVII	six hundred seventeen
DCXVIII	six hundred eighteen
DCXIX	six hundred nineteen
DCXX	six hundred twenty
DCXXI	six hundred twenty one
DCXXII	six hundred twenty two
DCXXIII	six hundred twenty three
DCXXIV	six hundred twenty four
DCXXV	six hundred twenty five
DCXXVI	six hundred twenty six
DCXXVII	six hundred twenty seven
DCXXVIII	six hundred twenty eight
DCXXIX	six hundred twenty nine
DCXXX	six hundred thirty
DCXXXI	six hundred thirty one
DCXXXII	six hundred thirty two
DCXXXIII	six hundred thirty three
DCXXXIV	six hundred thirty four
DCXXXV	six hundred thirty five
DCXXXVI	six hundred thirty six
DCXXXVII	six hundred thirty seven
DCXXXVIII	six hundred thirty eight
DCXXXIX	six hundred thirty nine
DCXL	six hundred forty
DCXLI	six hundred forty one
DCXLII	six hundred forty two
DCXLIII	six hundred forty three
DCXLIV	six hundred forty four
DCXLV	six hundred forty five
DCXLVI	six hundred forty six
DCXLVII	six hundred forty seven
DCXLVIII	six hundred forty eight
DCXLIX	six hundred forty nine
DCL	six hundred fifty
DCLI	six hundred fifty one
DCLII	six hundred fifty two
DCLIII	six hundred fifty three
DCLIV	six hundred fifty four
DCLV	six hundred fifty five
DCLVI	six hundred fifty six
DCLVII	six hundred fifty seven
DCLVIII	six hundred fifty eight
DCLIX	six hundred fifty nine
DCLX	six hundred sixty
DCLXI	six hundred sixty one
DCLXII	six hundred sixty two
DCLXIII	six hundred sixty three
DCLXIV	six hundred sixty four
DCLXV	six hundred sixty five
DCLXVI	six hundred sixty six
DCLXVII	six hundred sixty seven
DCLXVIII	six hundred sixty eight
DCLXIX	six hundred sixty nine
DCLXX	six hundred seventy
DCLXXI	six hundred seventy one
DCLXXII	six hundred seventy two
DCLXXIII	six hundred seventy three
DCLXXIV	six hundred seventy four
DCLXXV	six hundred seventy five
DCLXXVI	six hundred seventy six
DCLXXVII	six hundred seventy seven
DCLXXVIII	six hundred seventy eight
DCLXXIX	six hundred seventy nine
DCLXXX	six hundred eighty
DCLXXXI	six hundred eighty one
DCLXXXII	six hundred eighty two
DCLXXXIII	six hundred eighty three
DCLXXXIV	six hundred eighty four
DCLXXXV	six hundred eighty five
DCLXXXVI	six hundred eighty six
DCLXXXVII	six hundred eighty seven
DCLXXXVIII	six hundred eighty eight
DCLXXXIX	six hundred eighty nine
DCXC	six hundred ninety
DCXCI	six hundred ninety one
DCXCII	six hundred ninety two
DCXCIII	six hundred ninety three
DCXCIV	six hundred ninety four
DCXCV	six hundred ninety five
DCXCVI	six hundred ninety six
DCXCVII	six hundred ninety seven
DCXCVIII	six hundred ninety eight
DCXCIX	six hundred ninety nine
DCC	seven hundred
DCCI	seven hundred one
DCCII	seven hundred two
DCCIII	seven hundred three
DCCIV	seven hundred four
DCCV	seven hundred five
DCCVI	seven hundred six
DCCVII	seven hundred seven
DCCVIII	seven hundred eight
DCCIX	seven hundred nine
DCCX	seven hundred ten
DCCXI	seven hundred eleven
DCCXII	seven hundred twelve
DCCXIII	seven hundred thirteen
DCCXIV	seven hundred fourteen
DCCXV	seven hundred fifteen
DCCXVI	seven hundred sixteen
DCCXVII	seven hundred seventeen
DCCXVIII	seven hundred eighteen
DCCXIX	seven hundred nineteen
DCCXX	seven hundred twenty
DCCXXI	seven hundred twenty one
DCCXXII	seven hundred twenty two
DCCXXIII	seven hundred twenty three
DCCXXIV	seven hundred twenty four
DCCXXV	seven hundred twenty five
DCCXXVI	seven hundred twenty six
DCCXXVII	seven hundred twenty seven
DCCXXVIII	seven hundred twenty eight
DCCXXIX	seven hundred twenty nine
DCCXXX	seven hundred thirty
DCCXXXI	seven hundred thirty one
DCCXXXII	seven hundred thirty two
DCCXXXIII	seven hundred thirty three
DCCXXXIV	seven hundred thirty four
DCCXXXV	seven hundred thirty five
DCCXXXVI	seven hundred thirty six
DCCXXXVII	seven hundred thirty seven
DCCXXXVIII	seven hundred thirty eight
DCCXXXIX	seven hundred thirty nine
DCCXL	seven hundred forty
DCCXLI	seven hundred forty one
DCCXLII	seven hundred forty two
DCCXLIII	seven hundred forty three
DCCXLIV	seven hundred forty four
DCCXLV	seven hundred forty five
DCCXLVI	seven hundred forty six
DCCXLVII	seven hundred forty seven
DCCXLVIII	seven hundred forty eight
DCCXLIX	seven hundred forty nine
DCCL	seven hundred fifty
DCCLI	seven hundred fifty one
DCCLII	seven hundred fifty two
DCCLIII	seven hundred fifty three
DCCLIV	seven hundred fifty four
DCCLV	seven hundred fifty five
DCCLVI	seven hundred fifty six
DCCLVII	seven hundred fifty seven
DCCLVIII	seven hundred fifty eight
DCCLIX	seven hundred fifty nine
DCCLX	seven hundred sixty
DCCLXI	seven hundred sixty one
DCCLXII	seven hundred sixty two
DCCLXIII	seven hundred sixty three
DCCLXIV	seven hundred sixty four
DCCLXV	seven hundred sixty five
DCCLXVI	seven hundred sixty six
DCCLXVII	seven hundred sixty seven
DCCLXVIII	seven hundred sixty eight
DCCLXIX	seven hundred sixty nine
DCCLXX	seven hundred seventy
DCCLXXI	seven hundred seventy one
DCCLXXII	seven hundred seventy two
DCCLXXIII	seven hundred seventy three
DCCLXXIV	seven hundred seventy four
DCCLXXV	seven hundred seventy five
DCCLXXVI	seven hundred seventy six
DCCLXXVII	seven hundred seventy seven
DCCLXXVIII	seven hundred seventy eight
DCCLXXIX	seven hundred seventy nine
DCCLXXX	seven hundred eighty
DCCLXXXI	seven hundred eighty one
DCCLXXXII	seven hundred eighty two
DCCLXXXIII	seven hundred eighty three
DCCLXXXIV	seven hundred eighty four
DCCLXXXV	seven hundred eighty five
DCCLXXXVI	seven hundred eighty six
DCCLXXXVII	seven hundred eighty seven
DCCLXXXVIII	seven hundred eighty eight
DCCLXXXIX	seven hundred eighty nine
DCCXC	seven hundred ninety
DCCXCI	seven hundred ninety one
DCCXCII	seven hundred ninety two
DCCXCIII	seven hundred ninety three
DCCXCIV	seven hundred ninety four
DCCXCV	seven hundred ninety five
DCCXCVI	seven hundred ninety six
DCCXCVII	seven hundred ninety seven
DCCXCVIII	seven hundred ninety eight
DCCXCIX	seven hundred ninety nine
DCCC	eight hundred
DCCCI	eight hundred one
DCCCII	eight hundred two
DCCCIII	eight hundred three
DCCCIV	eight hundred four
DCCCV	eight hundred five
DCCCVI	eight hundred six
DCCCVII	eight hundred seven
DCCCVIII	eight hundred eight
DCCCIX	eight hundred nine
DCCCX	eight hundred ten
DCCCXI	eight hundred eleven
DCCCXII	eight hundred twelve
DCCCXIII	eight hundred thirteen
DCCCXIV	eight hundred fourteen
DCCCXV	eight hundred fifteen
DCCCXVI	eight hundred sixteen
DCCCXVII	eight hundred seventeen
DCCCXVIII	eight hundred eighteen
DCCCXIX	eight hundred nineteen
DCCCXX	eight hundred twenty
DCCCXXI	eight hundred twenty one
DCCCXXII	eight hundred twenty two
DCCCXXIII	eight hundred twenty three
DCCCXXIV	eight hundred twenty four
DCCCXXV	eight hundred twenty five
DCCCXXVI	eight hundred twenty six
DCCCXXVII	eight hundred twenty seven
DCCCXXVIII	eight hundred twenty eight
DCCCXXIX	eight hundred twenty nine
DCCCXXX	eight hundred thirty
DCCCXXXI	eight hundred thirty one
DCCCXXXII	eight hundred thirty two
DCCCXXXIII	eight hundred thirty three
DCCCXXXIV	eight hundred thirty four
DCCCXXXV	eight hundred thirty five
DCCCXXXVI	eight hundred thirty six
DCCCXXXVII	eight hundred thirty seven
DCCCXXXVIII	eight hundred thirty eight
DCCCXXXIX	eight hundred thirty nine
DCCCXL	eight hundred forty
DCCCXLI	eight hundred forty one
DCCCXLII	eight hundred forty two
DCCCXLIII	eight hundred forty three
DCCCXLIV	eight hundred forty four
DCCCXLV	eight hundred forty five
DCCCXLVI	eight hundred forty six
DCCCXLVII	eight hundred forty seven
DCCCXLVIII	eight hundred forty eight
DCCCXLIX	eight hundred forty nine
DCCCL	eight hundred fifty
DCCCLI	eight hundred fifty one
DCCCLII	eight hundred fifty two
DCCCLIII	eight hundred fifty three
DCCCLIV	eight hundred fifty four
DCCCLV	eight hundred fifty five
DCCCLVI	eight hundred fifty six
DCCCLVII	eight hundred fifty seven
DCCCLVIII	eight hundred fifty eight
DCCCLIX	eight hundred fifty nine
DCCCLX	eight hundred sixty
DCCCLXI	eight hundred sixty one
DCCCLXII	eight hundred sixty two
DCCCLXIII	eight hundred sixty three
DCCCLXIV	eight hundred sixty four
DCCCLXV	eight hundred sixty five
DCCCLXVI	eight hundred sixty six
DCCCLXVII	eight hundred sixty seven
DCCCLXVIII	eight hundred sixty eight
DCCCLXIX	eight hundred sixty nine
DCCCLXX	eight hundred seventy
DCCCLXXI	eight hundred seventy one
DCCCLXXII	eight hundred seventy two
DCCCLXXIII	eight hundred seventy three
DCCCLXXIV	eight hundred seventy four
DCCCLXXV	eight hundred seventy five
DCCCLXXVI	eight hundred seventy six
DCCCLXXVII	eight hundred seventy seven
DCCCLXXVIII	eight hundred seventy eight
DCCCLXXIX	eight hundred seventy nine
DCCCLXXX	eight hundred eighty
DCCCLXXXI	eight hundred eighty one
DCCCLXXXII	eight hundred eighty two
DCCCLXXXIII	eight hundred eighty three
DCCCLXXXIV	eight hundred eighty four
DCCCLXXXV	eight hundred eighty five
DCCCLXXXVI	eight hundred eighty six
DCCCLXXXVII	eight hundred eighty seven
DCCCLXXXVIII	eight hundred eighty eight
DCCCLXXXIX	eight hundred eighty nine
DCCCXC	eight hundred ninety
DCCCXCI	eight hundred ninety one
DCCCXCII	eight hundred ninety two
DCCCXCIII	eight hundred ninety three
DCCCXCIV	eight hundred ninety four
DCCCXCV	eight hundred ninety five
DCCCXCVI	eight hundred ninety six
DCCCXCVII	eight hundred ninety seven
DCCCXCVIII	eight hundred ninety eight
DCCCXCIX	eight hundred ninety nine
CM	nine hundred
CMI	nine hundred one
CMII	nine hundred two
CMIII	nine hundred three
CMIV	nine hundred four
CMV	nine hundred five
CMVI	nine hundred six
CMVII	nine hundred seven
CMVIII	nine hundred eight
CMIX	nine hundred nine
CMX	nine hundred ten
CMXI	nine hundred eleven
CMXII	nine hundred twelve
CMXIII	nine hundred thirteen
CMXIV	nine hundred fourteen
CMXV	nine hundred fifteen
CMXVI	nine hundred sixteen
CMXVII	nine hundred seventeen
CMXVIII	nine hundred eighteen
CMXIX	nine hundred nineteen
CMXX	nine hundred twenty
CMXXI	nine hundred twenty one
CMXXII	nine hundred twenty two
CMXXIII	nine hundred twenty three
CMXXIV	nine hundred twenty four
CMXXV	nine hundred twenty five
CMXXVI	nine hundred twenty six
CMXXVII	nine hundred twenty seven
CMXXVIII	nine hundred twenty eight
CMXXIX	nine hundred twenty nine
CMXXX	nine hundred thirty
CMXXXI	nine hundred thirty one
CMXXXII	nine hundred thirty two
CMXXXIII	nine hundred thirty three
CMXXXIV	nine hundred thirty four
CMXXXV	nine hundred thirty five
CMXXXVI	nine hundred thirty six
CMXXXVII	nine hundred thirty seven
CMXXXVIII	nine hundred thirty eight
CMXXXIX	nine hundred thirty nine
CMXL	nine hundred forty
CMXLI	nine hundred forty one
CMXLII	nine hundred forty two
CMXLIII	nine hundred forty three
CMXLIV	nine hundred forty four
CMXLV	nine hundred forty five
CMXLVI	nine hundred forty six
CMXLVII	nine hundred forty seven
CMXLVIII	nine hundred forty eight
CMXLIX	nine hundred forty nine
CML	nine hundred fifty
CMLI	nine hundred fifty one
CMLII	nine hundred fifty two
CMLIII	nine hundred fifty three
CMLIV	nine hundred fifty four
CMLV	nine hundred fifty five
CMLVI	nine hundred fifty six
CMLVII	nine hundred fifty seven
CMLVIII	nine hundred fifty eight
CMLIX	nine hundred fifty nine
CMLX	nine hundred sixty
CMLXI	nine hundred sixty one
CMLXII	nine hundred sixty two
CMLXIII	nine hundred sixty three
CMLXIV	nine hundred sixty four
CMLXV	nine hundred sixty five
CMLXVI	nine hundred sixty six
CMLXVII	nine hundred sixty seven
CMLXVIII	nine hundred sixty eight
CMLXIX	nine hundred sixty nine
CMLXX	nine hundred seventy
CMLXXI	nine hundred seventy one
CMLXXII	nine hundred seventy two
CMLXXIII	nine hundred seventy three
CMLXXIV	nine hundred seventy four
CMLXXV	nine hundred seventy five
CMLXXVI	nine hundred seventy six
CMLXXVII	nine hundred seventy seven
CMLXXVIII	nine hundred seventy eight
CMLXXIX	nine hundred seventy nine
CMLXXX	nine hundred eighty
CMLXXXI	nine hundred eighty one
CMLXXXII	nine hundred eighty two
CMLXXXIII	nine hundred eighty three
CMLXXXIV	nine hundred eighty four
CMLXXXV	nine hundred eighty five
CMLXXXVI	nine hundred eighty six
CMLXXXVII	nine hundred eighty seven
CMLXXXVIII	nine hundred eighty eight
CMLXXXIX	nine hundred eighty nine
CMXC	nine hundred ninety
CMXCI	nine hundred ninety one
CMXCII	nine hundred ninety two
CMXCIII	nine hundred ninety three
CMXCIV	nine hundred ninety four
CMXCV	nine hundred ninety five
CMXCVI	nine hundred ninety six
CMXCVII	nine hundred ninety seven
CMXCVIII	nine hundred ninety eight
CMXCIX	nine hundred ninety nine
M	one thousand
MI	one thousand one
MII	one thousand two
MIII	one thousand three
MIV	one thousand four
MV	one thousand five
MVI	one thousand six
MVII	one thousand seven
MVIII	one thousand eight
MIX	one thousand nine
MX	one thousand ten
MXI	one thousand eleven
MXII	one thousand twelve
MXIII	one thousand thirteen
MXIV	one thousand fourteen
MXV	one thousand fifteen
MXVI	one thousand sixteen
MXVII	one thousand seventeen
MXVIII	one thousand eighteen
MXIX	one thousand nineteen
MXX	one thousand twenty
MXXI	one thousand twenty one
MXXII	one thousand twenty two
MXXIII	one thousand twenty three
MXXIV	one thousand twenty four
MXXV	one thousand twenty five
MXXVI	one thousand twenty six
MXXVII	one thousand twenty seven
MXXVIII	one thousand twenty eight
MXXIX	one thousand twenty nine
MXXX	one thousand thirty
MXXXI	one thousand thirty one
MXXXII	one thousand thirty two
MXXXIII	one thousand thirty three
MXXXIV	one thousand thirty four
MXXXV	one thousand thirty five
MXXXVI	one thousand thirty six
MXXXVII	one thousand thirty seven
MXXXVIII	one thousand thirty eight
MXXXIX	one thousand thirty nine
MXL	one thousand forty
MXLI	one thousand forty one
MXLII	one thousand forty two
MXLIII	one thousand forty three
MXLIV	one thousand forty four
MXLV	one thousand forty five
MXLVI	one thousand forty six
MXLVII	one thousand forty seven
MXLVIII	one thousand forty eight
MXLIX	one thousand forty nine
ML	one thousand fifty
MLI	one thousand fifty one
MLII	one thousand fifty two
MLIII	one thousand fifty three
MLIV	one thousand fifty four
MLV	one thousand fifty five
MLVI	one thousand fifty six
MLVII	one thousand fifty seven
MLVIII	one thousand fifty eight
MLIX	one thousand fifty nine
MLX	one thousand sixty
MLXI	one thousand sixty one
MLXII	one thousand sixty two
MLXIII	one thousand sixty three
MLXIV	one thousand sixty four
MLXV	one thousand sixty five
MLXVI	one thousand sixty six
MLXVII	one thousand sixty seven
MLXVIII	one thousand sixty eight
MLXIX	one thousand sixty nine
MLXX	one thousand seventy
MLXXI	one thousand seventy one
MLXXII	one thousand seventy two
MLXXIII	one thousand seventy three
MLXXIV	one thousand seventy four
MLXXV	one thousand seventy five
MLXXVI	one thousand seventy six
MLXXVII	one thousand seventy seven
MLXXVIII	one thousand seventy eight
MLXXIX	one thousand seventy nine
MLXXX	one thousand eighty
MLXXXI	one thousand eighty one
MLXXXII	one thousand eighty two
MLXXXIII	one thousand eighty three
MLXXXIV	one thousand eighty four
MLXXXV	one thousand eighty five
MLXXXVI	one thousand eighty six
MLXXXVII	one thousand eighty seven
MLXXXVIII	one thousand eighty eight
MLXXXIX	one thousand eighty nine
MXC	one thousand ninety
MXCI	one thousand ninety one
MXCII	one thousand ninety two
MXCIII	one thousand ninety three
MXCIV	one thousand ninety four
MXCV	one thousand ninety five
MXCVI	one thousand ninety six
MXCVII	one thousand ninety seven
MXCVIII	one thousand ninety eight
MXCIX	one thousand ninety nine
MC	one thousand, one hundred
MCI	one thousand, one hundred one
MCII	one thousand, one hundred two
MCIII	one thousand, one hundred three
MCIV	one thousand, one hundred four
MCV	one thousand, one hundred five
MCVI	one thousand, one hundred six
MCVII	one thousand, one hundred seven
MCVIII	one thousand, one hundred eight
MCIX	one thousand, one hundred nine
MCX	one thousand, one hundred ten
MCXI	one thousand, one hundred eleven
MCXII	one thousand, one hundred twelve
MCXIII	one thousand, one hundred thirteen
MCXIV	one thousand, one hundred fourteen
MCXV	one thousand, one hundred fifteen
MCXVI	one thousand, one hundred sixteen
MCXVII	one thousand, one hundred seventeen
MCXVIII	one thousand, one hundred eighteen
MCXIX	one thousand, one hundred nineteen
MCXX	one thousand, one hundred twenty
MCXXI	one thousand, one hundred twenty one
MCXXII	one thousand, one hundred twenty two
MCXXIII	one thousand, one hundred twenty three
MCXXIV	one thousand, one hundred twenty four
MCXXV	one thousand, one hundred twenty five
MCXXVI	one thousand, one hundred twenty six
MCXXVII	one thousand, one hundred twenty seven
MCXXVIII	one thousand, one hundred twenty eight
MCXXIX	one thousand, one hundred twenty nine
MCXXX	one thousand, one hundred thirty
MCXXXI	one thousand, one hundred thirty one
MCXXXII	one thousand, one hundred thirty two
MCXXXIII	one thousand, one hundred thirty three
MCXXXIV	one thousand, one hundred thirty four
MCXXXV	one thousand, one hundred thirty five
MCXXXVI	one thousand, one hundred thirty six
MCXXXVII	one thousand, one hundred thirty seven
MCXXXVIII	one thousand, one hundred thirty eight
MCXXXIX	one thousand, one hundred thirty nine
MCXL	one thousand, one hundred forty
MCXLI	one thousand, one hundred forty one
MCXLII	one thousand, one hundred forty two
MCXLIII	one thousand, one hundred forty three
MCXLIV	one thousand, one hundred forty four
MCXLV	one thousand, one hundred forty five
MCXLVI	one thousand, one hundred forty six
MCXLVII	one thousand, one hundred forty seven
MCXLVIII	one thousand, one hundred forty eight
MCXLIX	one thousand, one hundred forty nine
MCL	one thousand, one hundred fifty
MCLI	one thousand, one hundred fifty one
MCLII	one thousand, one hundred fifty two
MCLIII	one thousand, one hundred fifty three
MCLIV	one thousand, one hundred fifty four
MCLV	one thousand, one hundred fifty five
MCLVI	one thousand, one hundred fifty six
MCLVII	one thousand, one hundred fifty seven
MCLVIII	one thousand, one hundred fifty eight
MCLIX	one thousand, one hundred fifty nine
MCLX	one thousand, one hundred sixty
MCLXI	one thousand, one hundred sixty one
MCLXII	one thousand, one hundred sixty two
MCLXIII	one thousand, one hundred sixty three
MCLXIV	one thousand, one hundred sixty four
MCLXV	one thousand, one hundred sixty five
MCLXVI	one thousand, one hundred sixty six
MCLXVII	one thousand, one hundred sixty seven
MCLXVIII	one thousand, one hundred sixty eight
MCLXIX	one thousand, one hundred sixty nine
MCLXX	one thousand, one hundred seventy
MCLXXI	one thousand, one hundred seventy one
MCLXXII	one thousand, one hundred seventy two
MCLXXIII	one thousand, one hundred seventy three
MCLXXIV	one thousand, one hundred seventy four
MCLXXV	one thousand, one hundred seventy five
MCLXXVI	one thousand, one hundred seventy six
MCLXXVII	one thousand, one hundred seventy seven
MCLXXVIII	one thousand, one hundred seventy eight
MCLXXIX	one thousand, one hundred seventy nine
MCLXXX	one thousand, one hundred eighty
MCLXXXI	one thousand, one hundred eighty one
MCLXXXII	one thousand, one hundred eighty two
MCLXXXIII	one thousand, one hundred eighty three
MCLXXXIV	one thousand, one hundred eighty four
MCLXXXV	one thousand, one hundred eighty five
MCLXXXVI	one thousand, one hundred eighty six
MCLXXXVII	one thousand, one hundred eighty seven
MCLXXXVIII	one thousand, one hundred eighty eight
MCLXXXIX	one thousand, one hundred eighty nine
MCXC	one thousand, one hundred ninety
MCXCI	one thousand, one hundred ninety one
MCXCII	one thousand, one hundred ninety two
MCXCIII	one thousand, one hundred ninety three
MCXCIV	one thousand, one hundred ninety four
MCXCV	one thousand, one hundred ninety five
MCXCVI	one thousand, one hundred ninety six
MCXCVII	one thousand, one hundred ninety seven
MCXCVIII	one thousand, one hundred ninety eight
MCXCIX	one thousand, one hundred ninety nine
MCC	one thousand, two hundred
MCCI	one thousand, two hundred one
MCCII	one thousand, two hundred two
MCCIII	one thousand, two hundred three
MCCIV	one thousand, two hundred four
MCCV	one thousand, two hundred five
MCCVI	one thousand, two hundred six
MCCVII	one thousand, two hundred seven
MCCVIII	one thousand, two hundred eight
MCCIX	one thousand, two hundred nine
MCCX	one thousand, two hundred ten
MCCXI	one thousand, two hundred eleven
MCCXII	one thousand, two hundred twelve
MCCXIII	one thousand, two hundred thirteen
MCCXIV	one thousand, two hundred fourteen
MCCXV	one thousand, two hundred fifteen
MCCXVI	one thousand, two hundred sixteen
MCCXVII	one thousand, two hundred seventeen
MCCXVIII	one thousand, two hundred eighteen
MCCXIX	one thousand, two hundred nineteen
MCCXX	one thousand, two hundred twenty
MCCXXI	one thousand, two hundred twenty one
MCCXXII	one thousand, two hundred twenty two
MCCXXIII	one thousand, two hundred twenty three
MCCXXIV	one thousand, two hundred twenty four
MCCXXV	one thousand, two hundred twenty five
MCCXXVI	one thousand, two hundred twenty six
MCCXXVII	one thousand, two hundred twenty seven
MCCXXVIII	one thousand, two hundred twenty eight
MCCXXIX	one thousand, two hundred twenty nine
MCCXXX	one thousand, two hundred thirty
MCCXXXI	one thousand, two hundred thirty one
MCCXXXII	one thousand, two hundred thirty two
MCCXXXIII	one thousand, two hundred thirty three
MCCXXXIV	one thousand, two hundred thirty four
MCCXXXV	one thousand, two hundred thirty five
MCCXXXVI	one thousand, two hundred thirty six
MCCXXXVII	one thousand, two hundred thirty seven
MCCXXXVIII	one thousand, two hundred thirty eight
MCCXXXIX	one thousand, two hundred thirty nine
MCCXL	one thousand, two hundred forty
MCCXLI	one thousand, two hundred forty one
MCCXLII	one thousand, two hundred forty two
MCCXLIII	one thousand, two hundred forty three
MCCXLIV	one thousand, two hundred forty four
MCCXLV	one thousand, two hundred forty five
MCCXLVI	one thousand, two hundred forty six
MCCXLVII	one thousand, two hundred forty seven
MCCXLVIII	one thousand, two hundred forty eight
MCCXLIX	one thousand, two hundred forty nine
MCCL	one thousand, two hundred fifty
MCCLI	one thousand, two hundred fifty one
MCCLII	one thousand, two hundred fifty two
MCCLIII	one thousand, two hundred fifty three
MCCLIV	one thousand, two hundred fifty four
MCCLV	one thousand, two hundred fifty five
MCCLVI	one thousand, two hundred fifty six
MCCLVII	one thousand, two hundred fifty seven
MCCLVIII	one thousand, two hundred fifty eight
MCCLIX	one thousand, two hundred fifty nine
MCCLX	one thousand, two hundred sixty
MCCLXI	one thousand, two hundred sixty one
MCCLXII	one thousand, two hundred sixty two
MCCLXIII	one thousand, two hundred sixty three
MCCLXIV	one thousand, two hundred sixty four
MCCLXV	one thousand, two hundred sixty five
MCCLXVI	one thousand, two hundred sixty six
MCCLXVII	one thousand, two hundred sixty seven
MCCLXVIII	one thousand, two hundred sixty eight
MCCLXIX	one thousand, two hundred sixty nine
MCCLXX	one thousand, two hundred seventy
MCCLXXI	one thousand, two hundred seventy one
MCCLXXII	one thousand, two hundred seventy two
MCCLXXIII	one thousand, two hundred seventy three
MCCLXXIV	one thousand, two hundred seventy four
MCCLXXV	one thousand, two hundred seventy five
MCCLXXVI	one thousand, two hundred seventy six
MCCLXXVII	one thousand, two hundred seventy seven
MCCLXXVIII	one thousand, two hundred seventy eight
MCCLXXIX	one thousand, two hundred seventy nine
MCCLXXX	one thousand, two hundred eighty
MCCLXXXI	one thousand, two hundred eighty one
MCCLXXXII	one thousand, two hundred eighty two
MCCLXXXIII	one thousand, two hundred eighty three
MCCLXXXIV	one thousand, two hundred eighty four
MCCLXXXV	one thousand, two hundred eighty five
MCCLXXXVI	one thousand, two hundred eighty six
MCCLXXXVII	one thousand, two hundred eighty seven
MCCLXXXVIII	one thousand, two hundred eighty eight
MCCLXXXIX	one thousand, two hundred eighty nine
MCCXC	one thousand, two hundred ninety
MCCXCI	one thousand, two hundred ninety one
MCCXCII	one thousand, two hundred ninety two
MCCXCIII	one thousand, two hundred ninety three
MCCXCIV	one thousand, two hundred ninety four
MCCXCV	one thousand, two hundred ninety five
MCCXCVI	one thousand, two hundred ninety six
MCCXCVII	one thousand, two hundred ninety seven
MCCXCVIII	one thousand, two hundred ninety eight
MCCXCIX	one thousand, two hundred ninety nine
MCCC	one thousand, three hundred
MCCCI	one thousand, three hundred one
MCCCII	one thousand, three hundred two
MCCCIII	one thousand, three hundred three
MCCCIV	one thousand, three hundred four
MCCCV	one thousand, three hundred five
MCCCVI	one thousand, three hundred six
MCCCVII	one thousand, three hundred seven
MCCCVIII	one thousand, three hundred eight
MCCCIX	one thousand, three hundred nine
MCCCX	one thousand, three hundred ten
MCCCXI	one thousand, three hundred eleven
MCCCXII	one thousand, three hundred twelve
MCCCXIII	one thousand, three hundred thirteen
MCCCXIV	one thousand, three hundred fourteen
MCCCXV	one thousand, three hundred fifteen
MCCCXVI	one thousand, three hundred sixteen
MCCCXVII	one thousand, three hundred seventeen
MCCCXVIII	one thousand, three hundred eighteen
MCCCXIX	one thousand, three hundred nineteen
MCCCXX	one thousand, three hundred twenty
MCCCXXI	one thousand, three hundred twenty one
MCCCXXII	one thousand, three hundred twenty two
MCCCXXIII	one thousand, three hundred twenty three
MCCCXXIV	one thousand, three hundred twenty four
MCCCXXV	one thousand, three hundred twenty five
MCCCXXVI	one thousand, three hundred twenty six
MCCCXXVII	one thousand, three hundred twenty seven
MCCCXXVIII	one thousand, three hundred twenty eight
MCCCXXIX	one thousand, three hundred twenty nine
MCCCXXX	one thousand, three hundred thirty
MCCCXXXI	one thousand, three hundred thirty one
MCCCXXXII	one thousand, three hundred thirty two
MCCCXXXIII	one thousand, three hundred thirty three
MCCCXXXIV	one thousand, three hundred thirty four
MCCCXXXV	one thousand, three hundred thirty five
MCCCXXXVI	one thousand, three hundred thirty six
MCCCXXXVII	one thousand, three hundred thirty seven
MCCCXXXVIII	one thousand, three hundred thirty eight
MCCCXXXIX	one thousand, three hundred thirty nine
MCCCXL	one thousand, three hundred forty
MCCCXLI	one thousand, three hundred forty one
MCCCXLII	one thousand, three hundred forty two
MCCCXLIII	one thousand, three hundred forty three
MCCCXLIV	one thousand, three hundred forty four
MCCCXLV	one thousand, three hundred forty five
MCCCXLVI	one thousand, three hundred forty six
MCCCXLVII	one thousand, three hundred forty seven
MCCCXLVIII	one thousand, three hundred forty eight
MCCCXLIX	one thousand, three hundred forty nine
MCCCL	one thousand, three hundred fifty
MCCCLI	one thousand, three hundred fifty one
MCCCLII	one thousand, three hundred fifty two
MCCCLIII	one thousand, three hundred fifty three
MCCCLIV	one thousand, three hundred fifty four
MCCCLV	one thousand, three hundred fifty five
MCCCLVI	one thousand, three hundred fifty six
MCCCLVII	one thousand, three hundred fifty seven
MCCCLVIII	one thousand, three hundred fifty eight
MCCCLIX	one thousand, three hundred fifty nine
MCCCLX	one thousand, three hundred sixty
MCCCLXI	one thousand, three hundred sixty one
MCCCLXII	one thousand, three hundred sixty two
MCCCLXIII	one thousand, three hundred sixty three
MCCCLXIV	one thousand, three hundred sixty four
MCCCLXV	one thousand, three hundred sixty five
MCCCLXVI	one thousand, three hundred sixty six
MCCCLXVII	one thousand, three hundred sixty seven
MCCCLXVIII	one thousand, three hundred sixty eight
MCCCLXIX	one thousand, three hundred sixty nine
MCCCLXX	one thousand, three hundred seventy
MCCCLXXI	one thousand, three hundred seventy one
MCCCLXXII	one thousand, three hundred seventy two
MCCCLXXIII	one thousand, three hundred seventy three
MCCCLXXIV	one thousand, three hundred seventy four
MCCCLXXV	one thousand, three hundred seventy five
MCCCLXXVI	one thousand, three hundred seventy six
MCCCLXXVII	one thousand, three hundred seventy seven
MCCCLXXVIII	one thousand, three hundred seventy eight
MCCCLXXIX	one thousand, three hundred seventy nine
MCCCLXXX	one thousand, three hundred eighty
MCCCLXXXI	one thousand, three hundred eighty one
MCCCLXXXII	one thousand, three hundred eighty two
MCCCLXXXIII	one thousand, three hundred eighty three
MCCCLXXXIV	one thousand, three hundred eighty four
MCCCLXXXV	one thousand, three hundred eighty five
MCCCLXXXVI	one thousand, three hundred eighty six
MCCCLXXXVII	one thousand, three hundred eighty seven
MCCCLXXXVIII	one thousand, three hundred eighty eight
MCCCLXXXIX	one thousand, three hundred eighty nine
MCCCXC	one thousand, three hundred ninety
MCCCXCI	one thousand, three hundred ninety one
MCCCXCII	one thousand, three hundred ninety two
MCCCXCIII	one thousand, three hundred ninety three
MCCCXCIV	one thousand, three hundred ninety four
MCCCXCV	one thousand, three hundred ninety five
MCCCXCVI	one thousand, three hundred ninety six
MCCCXCVII	one thousand, three hundred ninety seven
MCCCXCVIII	one thousand, three hundred ninety eight
MCCCXCIX	one thousand, three hundred ninety nine
MCD	one thousand, four hundred
MCDI	one thousand, four hundred one
MCDII	one thousand, four hundred two
MCDIII	one thousand, four hundred three
MCDIV	one thousand, four hundred four
MCDV	one thousand, four hundred five
MCDVI	one thousand, four hundred six
MCDVII	one thousand, four hundred seven
MCDVIII	one thousand, four hundred eight
MCDIX	one thousand, four hundred nine
MCDX	one thousand, four hundred ten
MCDXI	one thousand, four hundred eleven
MCDXII	one thousand, four hundred twelve
MCDXIII	one thousand, four hundred thirteen
MCDXIV	one thousand, four hundred fourteen
MCDXV	one thousand, four hundred fifteen
MCDXVI	one thousand, four hundred sixteen
MCDXVII	one thousand, four hundred seventeen
MCDXVIII	one thousand, four hundred eighteen
MCDXIX	one thousand, four hundred nineteen
MCDXX	one thousand, four hundred twenty
MCDXXI	one thousand, four hundred twenty one
MCDXXII	one thousand, four hundred twenty two
MCDXXIII	one thousand, four hundred twenty three
MCDXXIV	one thousand, four hundred twenty four
MCDXXV	one thousand, four hundred twenty five
MCDXXVI	one thousand, four hundred twenty six
MCDXXVII	one thousand, four hundred twenty seven
MCDXXVIII	one thousand, four hundred twenty eight
MCDXXIX	one thousand, four hundred twenty nine
MCDXXX	one thousand, four hundred thirty
MCDXXXI	one thousand, four hundred thirty one
MCDXXXII	one thousand, four hundred thirty two
MCDXXXIII	one thousand, four hundred thirty three
MCDXXXIV	one thousand, four hundred thirty four
MCDXXXV	one thousand, four hundred thirty five
MCDXXXVI	one thousand, four hundred thirty six
MCDXXXVII	one thousand, four hundred thirty seven
MCDXXXVIII	one thousand, four hundred thirty eight
MCDXXXIX	one thousand, four hundred thirty nine
MCDXL	one thousand, four hundred forty
MCDXLI	one thousand, four hundred forty one
MCDXLII	one thousand, four hundred forty two
MCDXLIII	one thousand, four hundred forty three
MCDXLIV	one thousand, four hundred forty four
MCDXLV	one thousand, four hundred forty five
MCDXLVI	one thousand, four hundred forty six
MCDXLVII	one thousand, four hundred forty seven
MCDXLVIII	one thousand, four hundred forty eight
MCDXLIX	one thousand, four hundred forty nine
MCDL	one thousand, four hundred fifty
MCDLI	one thousand, four hundred fifty one
MCDLII	one thousand, four hundred fifty two
MCDLIII	one thousand, four hundred fifty three
MCDLIV	one thousand, four hundred fifty four
MCDLV	one thousand, four hundred fifty five
MCDLVI	one thousand, four hundred fifty six
MCDLVII	one thousand, four hundred fifty seven
MCDLVIII	one thousand, four hundred fifty eight
MCDLIX	one thousand, four hundred fifty nine
MCDLX	one thousand, four hundred sixty
MCDLXI	one thousand, four hundred sixty one
MCDLXII	one thousand, four hundred sixty two
MCDLXIII	one thousand, four hundred sixty three
MCDLXIV	one thousand, four hundred sixty four
MCDLXV	one thousand, four hundred sixty five
MCDLXVI	one thousand, four hundred sixty six
MCDLXVII	one thousand, four hundred sixty seven
MCDLXVIII	one thousand, four hundred sixty eight
MCDLXIX	one thousand, four hundred sixty nine
MCDLXX	one thousand, four hundred seventy
MCDLXXI	one thousand, four hundred seventy one
MCDLXXII	one thousand, four hundred seventy two
MCDLXXIII	one thousand, four hundred seventy three
MCDLXXIV	one thousand, four hundred seventy four
MCDLXXV	one thousand, four hundred seventy five
MCDLXXVI	one thousand, four hundred seventy six
MCDLXXVII	one thousand, four hundred seventy seven
MCDLXXVIII	one thousand, four hundred seventy eight
MCDLXXIX	one thousand, four hundred seventy nine
MCDLXXX	one thousand, four hundred eighty
MCDLXXXI	one thousand, four hundred eighty one
MCDLXXXII	one thousand, four hundred eighty two
MCDLXXXIII	one thousand, four hundred eighty three
MCDLXXXIV	one thousand, four hundred eighty four
MCDLXXXV	one thousand, four hundred eighty five
MCDLXXXVI	one thousand, four hundred eighty six
MCDLXXXVII	one thousand, four hundred eighty seven
MCDLXXXVIII	one thousand, four hundred eighty eight
MCDLXXXIX	one thousand, four hundred eighty nine
MCDXC	one thousand, four hundred ninety
MCDXCI	one thousand, four hundred ninety one
MCDXCII	one thousand, four hundred ninety two
MCDXCIII	one thousand, four hundred ninety three
MCDXCIV	one thousand, four hundred ninety four
MCDXCV	one thousand, four hundred ninety five
MCDXCVI	one thousand, four hundred ninety six
MCDXCVII	one thousand, four hundred ninety seven
MCDXCVIII	one thousand, four hundred ninety eight
MCDXCIX	one thousand, four hundred ninety nine
MD	one thousand, five hundred
MDI	one thousand, five hundred one
MDII	one thousand, five hundred two
MDIII	one thousand, five hundred three
MDIV	one thousand, five hundred four
MDV	one thousand, five hundred five
MDVI	one thousand, five hundred six
MDVII	one thousand, five hundred seven
MDVIII	one thousand, five hundred eight
MDIX	one thousand, five hundred nine
MDX	one thousand, five hundred ten
MDXI	one thousand, five hundred eleven
MDXII	one thousand, five hundred twelve
MDXIII	one thousand, five hundred thirteen
MDXIV	one thousand, five hundred fourteen
MDXV	one thousand, five hundred fifteen
MDXVI	one thousand, five hundred sixteen
MDXVII	one thousand, five hundred seventeen
MDXVIII	one thousand, five hundred eighteen
MDXIX	one thousand, five hundred nineteen
MDXX	one thousand, five hundred twenty
MDXXI	one thousand, five hundred twenty one
MDXXII	one thousand, five hundred twenty two
MDXXIII	one thousand, five hundred twenty three
MDXXIV	one thousand, five hundred twenty four
MDXXV	one thousand, five hundred twenty five
MDXXVI	one thousand, five hundred twenty six
MDXXVII	one thousand, five hundred twenty seven
MDXXVIII	one thousand, five hundred twenty eight
MDXXIX	one thousand, five hundred twenty nine
MDXXX	one thousand, five hundred thirty
MDXXXI	one thousand, five hundred thirty one
MDXXXII	one thousand, five hundred thirty two
MDXXXIII	one thousand, five hundred thirty three
MDXXXIV	one thousand, five hundred thirty four
MDXXXV	one thousand, five hundred thirty five
MDXXXVI	one thousand, five hundred thirty six
MDXXXVII	one thousand, five hundred thirty seven
MDXXXVIII	one thousand, five hundred thirty eight
MDXXXIX	one thousand, five hundred thirty nine
MDXL	one thousand, five hundred forty
MDXLI	one thousand, five hundred forty one
MDXLII	one thousand, five hundred forty two
MDXLIII	one thousand, five hundred forty three
MDXLIV	one thousand, five hundred forty four
MDXLV	one thousand, five hundred forty five
MDXLVI	one thousand, five hundred forty six
MDXLVII	one thousand, five hundred forty seven
MDXLVIII	one thousand, five hundred forty eight
MDXLIX	one thousand, five hundred forty nine
MDL	one thousand, five hundred fifty
MDLI	one thousand, five hundred fifty one
MDLII	one thousand, five hundred fifty two
MDLIII	one thousand, five hundred fifty three
MDLIV	one thousand, five hundred fifty four
MDLV	one thousand, five hundred fifty five
MDLVI	one thousand, five hundred fifty six
MDLVII	one thousand, five hundred fifty seven
MDLVIII	one thousand, five hundred fifty eight
MDLIX	one thousand, five hundred fifty nine
MDLX	one thousand, five hundred sixty
MDLXI	one thousand, five hundred sixty one
MDLXII	one thousand, five hundred sixty two
MDLXIII	one thousand, five hundred sixty three
MDLXIV	one thousand, five hundred sixty four
MDLXV	one thousand, five hundred sixty five
MDLXVI	one thousand, five hundred sixty six
MDLXVII	one thousand, five hundred sixty seven
MDLXVIII	one thousand, five hundred sixty eight
MDLXIX	one thousand, five hundred sixty nine
MDLXX	one thousand, five hundred seventy
MDLXXI	one thousand, five hundred seventy one
MDLXXII	one thousand, five hundred seventy two
MDLXXIII	one thousand, five hundred seventy three
MDLXXIV	one thousand, five hundred seventy four
MDLXXV	one thousand, five hundred seventy five
MDLXXVI	one thousand, five hundred seventy six
MDLXXVII	one thousand, five hundred seventy seven
MDLXXVIII	one thousand, five hundred seventy eight
MDLXXIX	one thousand, five hundred seventy nine
MDLXXX	one thousand, five hundred eighty
MDLXXXI	one thousand, five hundred eighty one
MDLXXXII	one thousand, five hundred eighty two
MDLXXXIII	one thousand, five hundred eighty three
MDLXXXIV	one thousand, five hundred eighty four
MDLXXXV	one thousand, five hundred eighty five
MDLXXXVI	one thousand, five hundred eighty six
MDLXXXVII	one thousand, five hundred eighty seven
MDLXXXVIII	one thousand, five hundred eighty eight
MDLXXXIX	one thousand, five hundred eighty nine
MDXC	one thousand, five hundred ninety
MDXCI	one thousand, five hundred ninety one
MDXCII	one thousand, five hundred ninety two
MDXCIII	one thousand, five hundred ninety three
MDXCIV	one thousand, five hundred ninety four
MDXCV	one thousand, five hundred ninety five
MDXCVI	one thousand, five hundred ninety six
MDXCVII	one thousand, five hundred ninety seven
MDXCVIII	one thousand, five hundred ninety eight
MDXCIX	one thousand, five hundred ninety nine
MDC	one thousand, six hundred
MDCI	one thousand, six hundred one
MDCII	one thousand, six hundred two
MDCIII	one thousand, six hundred three
MDCIV	one thousand, six hundred four
MDCV	one thousand, six hundred five
MDCVI	one thousand, six hundred six
MDCVII	one thousand, six hundred seven
MDCVIII	one thousand, six hundred eight
MDCIX	one thousand, six hundred nine
MDCX	one thousand, six hundred ten
MDCXI	one thousand, six hundred eleven
MDCXII	one thousand, six hundred twelve
MDCXIII	one thousand, six hundred thirteen
MDCXIV	one thousand, six hundred fourteen
MDCXV	one thousand, six hundred fifteen
MDCXVI	one thousand, six hundred sixteen
MDCXVII	one thousand, six hundred seventeen
MDCXVIII	one thousand, six hundred eighteen
MDCXIX	one thousand, six hundred nineteen
MDCXX	one thousand, six hundred twenty
MDCXXI	one thousand, six hundred twenty one
MDCXXII	one thousand, six hundred twenty two
MDCXXIII	one thousand, six hundred twenty three
MDCXXIV	one thousand, six hundred twenty four
MDCXXV	one thousand, six hundred twenty five
MDCXXVI	one thousand, six hundred twenty six
MDCXXVII	one thousand, six hundred twenty seven
MDCXXVIII	one thousand, six hundred twenty eight
MDCXXIX	one thousand, six hundred twenty nine
MDCXXX	one thousand, six hundred thirty
MDCXXXI	one thousand, six hundred thirty one
MDCXXXII	one thousand, six hundred thirty two
MDCXXXIII	one thousand, six hundred thirty three
MDCXXXIV	one thousand, six hundred thirty four
MDCXXXV	one thousand, six hundred thirty five
MDCXXXVI	one thousand, six hundred thirty six
MDCXXXVII	one thousand, six hundred thirty seven
MDCXXXVIII	one thousand, six hundred thirty eight
MDCXXXIX	one thousand, six hundred thirty nine
MDCXL	one thousand, six hundred forty
MDCXLI	one thousand, six hundred forty one
MDCXLII	one thousand, six hundred forty two
MDCXLIII	one thousand, six hundred forty three
MDCXLIV	one thousand, six hundred forty four
MDCXLV	one thousand, six hundred forty five
MDCXLVI	one thousand, six hundred forty six
MDCXLVII	one thousand, six hundred forty seven
MDCXLVIII	one thousand, six hundred forty eight
MDCXLIX	one thousand, six hundred forty nine
MDCL	one thousand, six hundred fifty
MDCLI	one thousand, six hundred fifty one
MDCLII	one thousand, six hundred fifty two
MDCLIII	one thousand, six hundred fifty three
MDCLIV	one thousand, six hundred fifty four
MDCLV	one thousand, six hundred fifty five
MDCLVI	one thousand, six hundred fifty six
MDCLVII	one thousand, six hundred fifty seven
MDCLVIII	one thousand, six hundred fifty eight
MDCLIX	one thousand, six hundred fifty nine
MDCLX	one thousand, six hundred sixty
MDCLXI	one thousand, six hundred sixty one
MDCLXII	one thousand, six hundred sixty two
MDCLXIII	one thousand, six hundred sixty three
MDCLXIV	one thousand, six hundred sixty four
MDCLXV	one thousand, six hundred sixty five
MDCLXVI	one thousand, six hundred sixty six
MDCLXVII	one thousand, six hundred sixty seven
MDCLXVIII	one thousand, six hundred sixty eight
MDCLXIX	one thousand, six hundred sixty nine
MDCLXX	one thousand, six hundred seventy
MDCLXXI	one thousand, six hundred seventy one
MDCLXXII	one thousand, six hundred seventy two
MDCLXXIII	one thousand, six hundred seventy three
MDCLXXIV	one thousand, six hundred seventy four
MDCLXXV	one thousand, six hundred seventy five
MDCLXXVI	one thousand, six hundred seventy six
MDCLXXVII	one thousand, six hundred seventy seven
MDCLXXVIII	one thousand, six hundred seventy eight
MDCLXXIX	one thousand, six hundred seventy nine
MDCLXXX	one thousand, six hundred eighty
MDCLXXXI	one thousand, six hundred eighty one
MDCLXXXII	one thousand, six hundred eighty two
MDCLXXXIII	one thousand, six hundred eighty three
MDCLXXXIV	one thousand, six hundred eighty four
MDCLXXXV	one thousand, six hundred eighty five
MDCLXXXVI	one thousand, six hundred eighty six
MDCLXXXVII	one thousand, six hundred eighty seven
MDCLXXXVIII	one thousand, six hundred eighty eight
MDCLXXXIX	one thousand, six hundred eighty nine
MDCXC	one thousand, six hundred ninety
MDCXCI	one thousand, six hundred ninety one
MDCXCII	one thousand, six hundred ninety two
MDCXCIII	one thousand, six hundred ninety three
MDCXCIV	one thousand, six hundred ninety four
MDCXCV	one thousand, six hundred ninety five
MDCXCVI	one thousand, six hundred ninety six
MDCXCVII	one thousand, six hundred ninety seven
MDCXCVIII	one thousand, six hundred ninety eight
MDCXCIX	one thousand, six hundred ninety nine
MDCC	one thousand, seven hundred
MDCCI	one thousand, seven hundred one
MDCCII	one thousand, seven hundred two
MDCCIII	one thousand, seven hundred three
MDCCIV	one thousand, seven hundred four
MDCCV	one thousand, seven hundred five
MDCCVI	one thousand, seven hundred six
MDCCVII	one thousand, seven hundred seven
MDCCVIII	one thousand, seven hundred eight
MDCCIX	one thousand, seven hundred nine
MDCCX	one thousand, seven hundred ten
MDCCXI	one thousand, seven hundred eleven
MDCCXII	one thousand, seven hundred twelve
MDCCXIII	one thousand, seven hundred thirteen
MDCCXIV	one thousand, seven hundred fourteen
MDCCXV	one thousand, seven hundred fifteen
MDCCXVI	one thousand, seven hundred sixteen
MDCCXVII	one thousand, seven hundred seventeen
MDCCXVIII	one thousand, seven hundred eighteen
MDCCXIX	one thousand, seven hundred nineteen
MDCCXX	one thousand, seven hundred twenty
MDCCXXI	one thousand, seven hundred twenty one
MDCCXXII	one thousand, seven hundred twenty two
MDCCXXIII	one thousand, seven hundred twenty three
MDCCXXIV	one thousand, seven hundred twenty four
MDCCXXV	one thousand, seven hundred twenty five
MDCCXXVI	one thousand, seven hundred twenty six
MDCCXXVII	one thousand, seven hundred twenty seven
MDCCXXVIII	one thousand, seven hundred twenty eight
MDCCXXIX	one thousand, seven hundred twenty nine
MDCCXXX	one thousand, seven hundred thirty
MDCCXXXI	one thousand, seven hundred thirty one
MDCCXXXII	one thousand, seven hundred thirty two
MDCCXXXIII	one thousand, seven hundred thirty three
MDCCXXXIV	one thousand, seven hundred thirty four
MDCCXXXV	one thousand, seven hundred thirty five
MDCCXXXVI	one thousand, seven hundred thirty six
MDCCXXXVII	one thousand, seven hundred thirty seven
MDCCXXXVIII	one thousand, seven hundred thirty eight
MDCCXXXIX	one thousand, seven hundred thirty nine
MDCCXL	one thousand, seven hundred forty
MDCCXLI	one thousand, seven hundred forty one
MDCCXLII	one thousand, seven hundred forty two
MDCCXLIII	one thousand, seven hundred forty three
MDCCXLIV	one thousand, seven hundred forty four
MDCCXLV	one thousand, seven hundred forty five
MDCCXLVI	one thousand, seven hundred forty six
MDCCXLVII	one thousand, seven hundred forty seven
MDCCXLVIII	one thousand, seven hundred forty eight
MDCCXLIX	one thousand, seven hundred forty nine
MDCCL	one thousand, seven hundred fifty
MDCCLI	one thousand, seven hundred fifty one
MDCCLII	one thousand, seven hundred fifty two
MDCCLIII	one thousand, seven hundred fifty three
MDCCLIV	one thousand, seven hundred fifty four
MDCCLV	one thousand, seven hundred fifty five
MDCCLVI	one thousand, seven hundred fifty six
MDCCLVII	one thousand, seven hundred fifty seven
MDCCLVIII	one thousand, seven hundred fifty eight
MDCCLIX	one thousand, seven hundred fifty nine
MDCCLX	one thousand, seven hundred sixty
MDCCLXI	one thousand, seven hundred sixty one
MDCCLXII	one thousand, seven hundred sixty two
MDCCLXIII	one thousand, seven hundred sixty three
MDCCLXIV	one thousand, seven hundred sixty four
MDCCLXV	one thousand, seven hundred sixty five
MDCCLXVI	one thousand, seven hundred sixty six
MDCCLXVII	one thousand, seven hundred sixty seven
MDCCLXVIII	one thousand, seven hundred sixty eight
MDCCLXIX	one thousand, seven hundred sixty nine
MDCCLXX	one thousand, seven hundred seventy
MDCCLXXI	one thousand, seven hundred seventy one
MDCCLXXII	one thousand, seven hundred seventy two
MDCCLXXIII	one thousand, seven hundred seventy three
MDCCLXXIV	one thousand, seven hundred seventy four
MDCCLXXV	one thousand, seven hundred seventy five
MDCCLXXVI	one thousand, seven hundred seventy six
MDCCLXXVII	one thousand, seven hundred seventy seven
MDCCLXXVIII	one thousand, seven hundred seventy eight
MDCCLXXIX	one thousand, seven hundred seventy nine
MDCCLXXX	one thousand, seven hundred eighty
MDCCLXXXI	one thousand, seven hundred eighty one
MDCCLXXXII	one thousand, seven hundred eighty two
MDCCLXXXIII	one thousand, seven hundred eighty three
MDCCLXXXIV	one thousand, seven hundred eighty four
MDCCLXXXV	one thousand, seven hundred eighty five
MDCCLXXXVI	one thousand, seven hundred eighty six
MDCCLXXXVII	one thousand, seven hundred eighty seven
MDCCLXXXVIII	one thousand, seven hundred eighty eight
MDCCLXXXIX	one thousand, seven hundred eighty nine
MDCCXC	one thousand, seven hundred ninety
MDCCXCI	one thousand, seven hundred ninety one
MDCCXCII	one thousand, seven hundred ninety two
MDCCXCIII	one thousand, seven hundred ninety three
MDCCXCIV	one thousand, seven hundred ninety four
MDCCXCV	one thousand, seven hundred ninety five
MDCCXCVI	one thousand, seven hundred ninety six
MDCCXCVII	one thousand, seven hundred ninety seven
MDCCXCVIII	one thousand, seven hundred ninety eight
MDCCXCIX	one thousand, seven hundred ninety nine
MDCCC	one thousand, eight hundred
MDCCCI	one thousand, eight hundred one
MDCCCII	one thousand, eight hundred two
MDCCCIII	one thousand, eight hundred three
MDCCCIV	one thousand, eight hundred four
MDCCCV	one thousand, eight hundred five
MDCCCVI	one thousand, eight hundred six
MDCCCVII	one thousand, eight hundred seven
MDCCCVIII	one thousand, eight hundred eight
MDCCCIX	one thousand, eight hundred nine
MDCCCX	one thousand, eight hundred ten
MDCCCXI	one thousand, eight hundred eleven
MDCCCXII	one thousand, eight hundred twelve
MDCCCXIII	one thousand, eight hundred thirteen
MDCCCXIV	one thousand, eight hundred fourteen
MDCCCXV	one thousand, eight hundred fifteen
MDCCCXVI	one thousand, eight hundred sixteen
MDCCCXVII	one thousand, eight hundred seventeen
MDCCCXVIII	one thousand, eight hundred eighteen
MDCCCXIX	one thousand, eight hundred nineteen
MDCCCXX	one thousand, eight hundred twenty
MDCCCXXI	one thousand, eight hundred twenty one
MDCCCXXII	one thousand, eight hundred twenty two
MDCCCXXIII	one thousand, eight hundred twenty three
MDCCCXXIV	one thousand, eight hundred twenty four
MDCCCXXV	one thousand, eight hundred twenty five
MDCCCXXVI	one thousand, eight hundred twenty six
MDCCCXXVII	one thousand, eight hundred twenty seven
MDCCCXXVIII	one thousand, eight hundred twenty eight
MDCCCXXIX	one thousand, eight hundred twenty nine
MDCCCXXX	one thousand, eight hundred thirty
MDCCCXXXI	one thousand, eight hundred thirty one
MDCCCXXXII	one thousand, eight hundred thirty two
MDCCCXXXIII	one thousand, eight hundred thirty three
MDCCCXXXIV	one thousand, eight hundred thirty four
MDCCCXXXV	one thousand, eight hundred thirty five
MDCCCXXXVI	one thousand, eight hundred thirty six
MDCCCXXXVII	one thousand, eight hundred thirty seven
MDCCCXXXVIII	one thousand, eight hundred thirty eight
MDCCCXXXIX	one thousand, eight hundred thirty nine
MDCCCXL	one thousand, eight hundred forty
MDCCCXLI	one thousand, eight hundred forty one
MDCCCXLII	one thousand, eight hundred forty two
MDCCCXLIII	one thousand, eight hundred forty three
MDCCCXLIV	one thousand, eight hundred forty four
MDCCCXLV	one thousand, eight hundred forty five
MDCCCXLVI	one thousand, eight hundred forty six
MDCCCXLVII	one thousand, eight hundred forty seven
MDCCCXLVIII	one thousand, eight hundred forty eight
MDCCCXLIX	one thousand, eight hundred forty nine
MDCCCL	one thousand, eight hundred fifty
MDCCCLI	one thousand, eight hundred fifty one
MDCCCLII	one thousand, eight hundred fifty two
MDCCCLIII	one thousand, eight hundred fifty three
MDCCCLIV	one thousand, eight hundred fifty four
MDCCCLV	one thousand, eight hundred fifty five
MDCCCLVI	one thousand, eight hundred fifty six
MDCCCLVII	one thousand, eight hundred fifty seven
MDCCCLVIII	one thousand, eight hundred fifty eight
MDCCCLIX	one thousand, eight hundred fifty nine
MDCCCLX	one thousand, eight hundred sixty
MDCCCLXI	one thousand, eight hundred sixty one
MDCCCLXII	one thousand, eight hundred sixty two
MDCCCLXIII	one thousand, eight hundred sixty three
MDCCCLXIV	one thousand, eight hundred sixty four
MDCCCLXV	one thousand, eight hundred sixty five
MDCCCLXVI	one thousand, eight hundred sixty six
MDCCCLXVII	one thousand, eight hundred sixty seven
MDCCCLXVIII	one thousand, eight hundred sixty eight
MDCCCLXIX	one thousand, eight hundred sixty nine
MDCCCLXX	one thousand, eight hundred seventy
MDCCCLXXI	one thousand, eight hundred seventy one
MDCCCLXXII	one thousand, eight hundred seventy two
MDCCCLXXIII	one thousand, eight hundred seventy three
MDCCCLXXIV	one thousand, eight hundred seventy four
MDCCCLXXV	one thousand, eight hundred seventy five
MDCCCLXXVI	one thousand, eight hundred seventy six
MDCCCLXXVII	one thousand, eight hundred seventy seven
MDCCCLXXVIII	one thousand, eight hundred seventy eight
MDCCCLXXIX	one thousand, eight hundred seventy nine
MDCCCLXXX	one thousand, eight hundred eighty
MDCCCLXXXI	one thousand, eight hundred eighty one
MDCCCLXXXII	one thousand, eight hundred eighty two
MDCCCLXXXIII	one thousand, eight hundred eighty three
MDCCCLXXXIV	one thousand, eight hundred eighty four
MDCCCLXXXV	one thousand, eight hundred eighty five
MDCCCLXXXVI	one thousand, eight hundred eighty six
MDCCCLXXXVII	one thousand, eight hundred eighty seven
MDCCCLXXXVIII	one thousand, eight hundred eighty eight
MDCCCLXXXIX	one thousand, eight hundred eighty nine
MDCCCXC	one thousand, eight hundred ninety
MDCCCXCI	one thousand, eight hundred ninety one
MDCCCXCII	one thousand, eight hundred ninety two
MDCCCXCIII	one thousand, eight hundred ninety three
MDCCCXCIV	one thousand, eight hundred ninety four
MDCCCXCV	one thousand, eight hundred ninety five
MDCCCXCVI	one thousand, eight hundred ninety six
MDCCCXCVII	one thousand, eight hundred ninety seven
MDCCCXCVIII	one thousand, eight hundred ninety eight
MDCCCXCIX	one thousand, eight hundred ninety nine
MCM	one thousand, nine hundred
MCMI	one thousand, nine hundred one
MCMII	one thousand, nine hundred two
MCMIII	one thousand, nine hundred three
MCMIV	one thousand, nine hundred four
MCMV	one thousand, nine hundred five
MCMVI	one thousand, nine hundred six
MCMVII	one thousand, nine hundred seven
MCMVIII	one thousand, nine hundred eight
MCMIX	one thousand, nine hundred nine
MCMX	one thousand, nine hundred ten
MCMXI	one thousand, nine hundred eleven
MCMXII	one thousand, nine hundred twelve
MCMXIII	one thousand, nine hundred thirteen
MCMXIV	one thousand, nine hundred fourteen
MCMXV	one thousand, nine hundred fifteen
MCMXVI	one thousand, nine hundred sixteen
MCMXVII	one thousand, nine hundred seventeen
MCMXVIII	one thousand, nine hundred eighteen
MCMXIX	one thousand, nine hundred nineteen
MCMXX	one thousand, nine hundred twenty
MCMXXI	one thousand, nine hundred twenty one
MCMXXII	one thousand, nine hundred twenty two
MCMXXIII	one thousand, nine hundred twenty three
MCMXXIV	one thousand, nine hundred twenty four
MCMXXV	one thousand, nine hundred twenty five
MCMXXVI	one thousand, nine hundred twenty six
MCMXXVII	one thousand, nine hundred twenty seven
MCMXXVIII	one thousand, nine hundred twenty eight
MCMXXIX	one thousand, nine hundred twenty nine
MCMXXX	one thousand, nine hundred thirty
MCMXXXI	one thousand, nine hundred thirty one
MCMXXXII	one thousand, nine hundred thirty two
MCMXXXIII	one thousand, nine hundred thirty three
MCMXXXIV	one thousand, nine hundred thirty four
MCMXXXV	one thousand, nine hundred thirty five
MCMXXXVI	one thousand, nine hundred thirty six
MCMXXXVII	one thousand, nine hundred thirty seven
MCMXXXVIII	one thousand, nine hundred thirty eight
MCMXXXIX	one thousand, nine hundred thirty nine
MCMXL	one thousand, nine hundred forty
MCMXLI	one thousand, nine hundred forty one
MCMXLII	one thousand, nine hundred forty two
MCMXLIII	one thousand, nine hundred forty three
MCMXLIV	one thousand, nine hundred forty four
MCMXLV	one thousand, nine hundred forty five
MCMXLVI	one thousand, nine hundred forty six
MCMXLVII	one thousand, nine hundred forty seven
MCMXLVIII	one thousand, nine hundred forty eight
MCMXLIX	one thousand, nine hundred forty nine
MCML	one thousand, nine hundred fifty
MCMLI	one thousand, nine hundred fifty one
MCMLII	one thousand, nine hundred fifty two
MCMLIII	one thousand, nine hundred fifty three
MCMLIV	one thousand, nine hundred fifty four
MCMLV	one thousand, nine hundred fifty five
MCMLVI	one thousand, nine hundred fifty six
MCMLVII	one thousand, nine hundred fifty seven
MCMLVIII	one thousand, nine hundred fifty eight
MCMLIX	one thousand, nine hundred fifty nine
MCMLX	one thousand, nine hundred sixty
MCMLXI	one thousand, nine hundred sixty one
MCMLXII	one thousand, nine hundred sixty two
MCMLXIII	one thousand, nine hundred sixty three
MCMLXIV	one thousand, nine hundred sixty four
MCMLXV	one thousand, nine hundred sixty five
MCMLXVI	one thousand, nine hundred sixty six
MCMLXVII	one thousand, nine hundred sixty seven
MCMLXVIII	one thousand, nine hundred sixty eight
MCMLXIX	one thousand, nine hundred sixty nine
MCMLXX	one thousand, nine hundred seventy
MCMLXXI	one thousand, nine hundred seventy one
MCMLXXII	one thousand, nine hundred seventy two
MCMLXXIII	one thousand, nine hundred seventy three
MCMLXXIV	one thousand, nine hundred seventy four
MCMLXXV	one thousand, nine hundred seventy five
MCMLXXVI	one thousand, nine hundred seventy six
MCMLXXVII	one thousand, nine hundred seventy seven
MCMLXXVIII	one thousand, nine hundred seventy eight
MCMLXXIX	one thousand, nine hundred seventy nine
MCMLXXX	one thousand, nine hundred eighty
MCMLXXXI	one thousand, nine hundred eighty one
MCMLXXXII	one thousand, nine hundred eighty two
MCMLXXXIII	one thousand, nine hundred eighty three
MCMLXXXIV	one thousand, nine hundred eighty four
MCMLXXXV	one thousand, nine hundred eighty five
MCMLXXXVI	one thousand, nine hundred eighty six
MCMLXXXVII	one thousand, nine hundred eighty seven
MCMLXXXVIII	one thousand, nine hundred eighty eight
MCMLXXXIX	one thousand, nine hundred eighty nine
MCMXC	one thousand, nine hundred ninety
MCMXCI	one thousand, nine hundred ninety one
MCMXCII	one thousand, nine hundred ninety two
MCMXCIII	one thousand, nine hundred ninety three
MCMXCIV	one thousand, nine hundred ninety four
MCMXCV	one thousand, nine hundred ninety five
MCMXCVI	one thousand, nine hundred ninety six
MCMXCVII	one thousand, nine hundred ninety seven
MCMXCVIII	one thousand, nine hundred ninety eight
MCMXCIX	one thousand, nine hundred ninety nine
MM	two thousand
